features,Boston,Canberra,Geneva,Ottawa,Count
like,106,87,82,73,348
http,96,47,80,108,331
people,126,57,70,75,328
year,54,86,68,82,290
want,64,42,65,60,231
use,45,53,68,58,224
work,40,76,40,52,208
look,60,42,52,49,203
school,49,13,80,57,199
make,69,51,38,37,195
day,36,41,49,66,192
know,46,32,52,52,182
really,24,51,50,47,172
car,25,48,58,37,168
lot,35,50,39,44,168
place,37,51,52,24,164
way,52,45,40,22,159
city,48,39,36,34,157
great,36,49,29,29,143
geneva,0,0,142,0,142
right,56,35,26,23,140
live,38,30,42,25,135
try,21,37,40,30,128
canberra,0,124,0,0,124
le,0,1,116,5,122
bus,24,25,33,34,116
help,42,19,20,32,113
pay,26,25,40,22,113
public,24,16,57,15,112
la,1,1,94,13,109
start,23,18,30,37,108
drive,28,33,21,22,104
best,24,31,32,15,102
area,30,40,9,22,101
walk,32,20,28,19,99
bit,15,35,28,20,98
ask,27,19,25,26,97
question,45,12,13,27,97
bad,29,27,18,22,96
post,33,11,8,44,96
kid,21,15,32,27,95
month,14,23,33,22,92
boston,91,0,0,0,91
experience,10,15,37,28,90
service,13,30,11,33,87
week,25,25,15,22,87
leave,17,25,27,16,85
run,27,24,13,21,85
check,25,13,25,21,84
cost,28,22,21,13,84
end,26,19,19,20,84
maybe,17,13,29,24,83
probably,22,26,17,18,83
buy,12,15,26,29,82
home,17,27,13,25,82
local,20,7,32,23,82
park,20,32,12,18,82
price,11,16,37,18,82
old,14,20,26,21,81
pretty,18,26,26,10,80
stop,23,20,27,10,80
big,21,16,25,17,79
job,17,15,28,19,79
money,18,20,12,29,79
family,22,21,19,14,76
feel,26,16,17,17,76
ottawa,0,0,0,76,76
food,13,21,12,27,73
long,14,20,26,13,73
road,11,30,18,14,73
french,5,0,43,24,72
high,19,13,16,22,70
house,16,28,7,19,70
mean,17,15,22,16,70
ago,13,23,14,19,69
close,13,16,23,17,69
shop,8,43,11,7,69
et,0,0,63,5,68
nice,8,25,21,13,67
street,17,20,8,22,67
usually,11,14,28,14,67
far,15,16,21,14,66
happen,21,12,17,15,65
hear,8,10,9,38,65
minute,7,11,19,28,65
night,17,12,21,15,65
different,12,20,17,15,64
friend,9,14,20,21,64
group,25,13,15,9,62
issue,10,22,10,19,61
point,13,24,15,9,61
train,3,6,48,4,61
person,15,13,20,12,60
option,8,14,20,17,59
store,11,21,4,23,59
contact,28,2,5,23,58
little,11,18,13,16,58
traffic,11,12,27,8,58
able,14,9,14,20,57
build,16,19,5,17,57
care,19,14,8,16,57
government,18,23,4,12,57
recommend,12,18,14,13,57
away,19,14,10,13,56
ca,19,18,13,6,56
couple,5,20,13,18,56
hard,13,7,18,18,56
pour,0,1,35,20,56
stay,15,9,23,9,56
change,19,11,11,14,55
cheap,5,15,21,14,55
pa,3,0,34,18,55
town,21,15,17,2,55
du,0,0,49,5,54
en,0,1,46,7,54
free,10,11,20,13,54
market,1,14,10,29,54
quite,3,11,33,7,54
reason,7,13,17,17,54
restaurant,11,10,25,8,54
small,8,13,20,13,54
child,9,16,19,9,53
easy,12,11,13,17,53
hour,7,17,12,17,53
number,12,11,23,7,53
state,43,4,6,0,53
bike,24,6,17,5,52
life,20,6,15,11,52
plus,4,5,25,18,52
stuff,17,11,7,17,52
building,9,23,5,14,51
centre,0,30,7,14,51
company,11,3,19,18,51
lane,20,10,14,7,51
love,11,14,8,18,51
message,2,1,4,44,51
rent,9,8,26,8,51
sell,4,16,9,22,51
student,6,7,20,18,51
support,22,6,8,15,51
wait,10,13,10,18,51
worth,9,15,12,15,51
yes,5,10,28,8,51
act,6,37,4,3,50
remove,3,5,5,37,50
bring,9,12,10,18,49
case,11,10,19,9,49
consider,18,13,12,6,49
staff,6,17,19,7,49
turn,13,9,14,13,49
let,13,10,16,9,48
likely,14,14,10,10,48
send,10,9,17,12,48
talk,14,9,11,14,48
actually,16,14,9,8,47
country,11,8,18,10,47
expensive,15,7,17,8,47
line,21,8,3,15,47
cut,10,17,7,12,46
water,6,26,6,8,46
deal,14,5,9,16,44
guy,11,14,8,11,44
order,7,14,14,9,44
par,1,2,23,18,44
past,21,6,10,7,44
read,4,5,13,22,44
bar,14,12,9,8,43
definitely,7,15,10,11,43
include,14,11,11,7,43
international,3,5,35,0,43
police,8,16,10,9,43
speak,13,3,15,12,43
super,6,13,9,15,43
swiss,0,0,43,0,43
kind,20,7,5,10,42
les,0,0,38,4,42
plan,10,11,16,5,42
spot,16,11,10,5,42
community,22,12,1,6,41
course,6,6,20,9,41
est,0,0,39,2,41
hill,21,11,3,6,41
https,10,8,16,7,41
idea,10,5,14,12,41
lake,2,17,22,0,41
similar,13,10,9,9,41
winter,18,7,7,9,41
business,12,7,4,17,40
depend,3,8,19,10,40
later,9,5,4,22,40
light,4,13,18,5,40
offer,9,6,12,13,40
space,13,15,8,4,40
ce,0,0,19,20,39
game,7,6,3,23,39
housing,24,10,5,0,39
near,10,16,5,8,39
outside,9,10,7,13,39
trump,29,0,0,10,39
action,17,2,0,19,38
concern,18,2,0,18,38
door,10,8,6,14,38
enjoy,18,9,8,3,38
grow,8,8,7,15,38
list,7,14,4,13,38
private,5,2,26,5,38
specific,14,3,16,5,38
base,7,6,11,13,37
book,3,15,11,8,37
fine,12,8,9,8,37
fun,10,7,8,12,37
level,8,4,14,11,37
lose,14,5,8,10,37
perform,15,3,0,19,37
que,0,0,35,2,37
apartment,8,12,15,1,36
app,0,3,32,1,36
bank,7,1,10,18,36
half,4,15,6,11,36
north,17,12,0,7,36
problem,7,10,11,8,36
red,5,16,5,10,36
subreddit,16,4,0,16,36
switzerland,0,0,36,0,36
tax,4,10,16,6,36
university,9,18,7,2,36
charge,13,7,10,5,35
follow,6,6,17,6,35
happy,8,13,10,4,35
health,6,13,6,10,35
phone,5,6,12,12,35
snow,12,1,7,15,35
suggest,9,7,12,7,35
access,9,10,7,8,34
create,11,5,15,3,34
especially,13,7,7,7,34
ice,19,7,3,5,34
learn,7,8,10,9,34
mind,13,6,6,9,34
office,8,10,5,11,34
remember,5,12,5,12,34
sign,9,12,5,8,34
spend,11,5,12,6,34
cause,10,8,8,7,33
coffee,25,5,2,1,33
edit,9,5,7,12,33
meet,9,8,2,14,33
mention,8,9,13,3,33
room,8,2,10,13,33
absolutely,7,13,5,7,32
club,3,11,11,7,32
english,1,3,12,16,32
event,6,7,5,14,32
parking,2,11,7,12,32
program,11,6,1,14,32
st,17,8,4,3,32
transport,6,2,23,1,32
trip,5,6,17,4,32
woman,8,3,9,12,32
age,10,5,8,8,31
automatically,15,0,0,16,31
budget,6,12,10,3,31
chf,0,0,31,0,31
early,5,13,4,9,31
france,1,0,30,0,31
il,0,0,28,3,31
luck,2,8,11,10,31
morning,2,12,5,12,31
play,5,10,3,13,31
real,11,3,7,10,31
set,7,11,6,7,31
shit,11,9,5,6,31
type,5,5,13,8,31
website,6,5,12,8,31
world,11,3,11,6,31
choose,3,5,18,4,30
head,18,7,3,2,30
je,0,0,30,0,30
low,9,6,9,6,30
neighbour,0,2,0,28,30
pass,3,7,12,8,30
possible,9,7,10,4,30
recently,3,12,4,11,30
safe,11,2,10,7,30
share,2,3,11,14,30
test,7,12,4,7,30
une,0,0,27,3,30
visit,3,8,14,5,30
bot,13,0,0,16,29
canada,3,0,0,26,29
cover,10,5,7,7,29
dog,2,12,4,11,29
eat,3,9,11,6,29
federal,19,7,1,2,29
large,4,5,11,9,29
moderator,13,0,0,16,29
route,3,10,12,4,29
rue,0,0,29,0,29
station,14,2,8,5,29
understand,10,8,8,3,29
watch,11,5,6,7,29
account,4,5,15,4,28
believe,5,5,8,10,28
bridge,11,2,3,12,28
cold,11,6,5,6,28
google,10,6,10,2,28
immigrant,25,0,2,1,28
law,15,0,9,4,28
single,6,7,9,6,28
size,2,3,6,17,28
sorry,1,1,18,8,28
south,15,5,2,6,28
stand,6,5,8,9,28
ticket,4,1,14,9,28
block,4,10,10,3,27
class,8,2,7,10,27
downtown,9,0,3,15,27
fee,3,4,5,15,27
hand,7,8,5,7,27
owner,4,9,7,7,27
quality,4,7,10,6,27
report,7,5,7,8,27
saw,8,7,3,9,27
today,8,4,6,9,27
view,3,7,14,3,27
board,2,1,2,21,26
center,18,0,8,0,26
cool,9,8,4,5,26
doctor,4,11,2,9,26
fuck,12,5,3,6,26
information,14,2,5,5,26
member,6,10,4,6,26
note,5,8,3,10,26
pick,4,5,6,11,26
push,3,7,8,8,26
rate,7,6,10,3,26
review,2,5,1,18,26
save,4,7,9,6,26
si,0,0,26,0,26
sit,5,11,5,5,26
surprise,5,8,8,5,26
travel,4,3,18,1,26
unless,3,6,13,4,26
airport,4,7,11,3,25
cross,4,10,9,2,25
driver,0,7,7,11,25
entire,11,3,3,8,25
face,11,6,4,4,25
hold,9,5,4,7,25
insurance,3,3,15,4,25
location,7,7,4,7,25
online,5,3,9,8,25
parent,9,6,8,2,25
property,4,6,9,6,25
sound,4,7,4,10,25
sur,0,0,24,1,25
trail,17,4,2,2,25
answer,2,3,12,7,24
apply,1,3,13,7,24
basic,3,4,9,8,24
cambridge,24,0,0,0,24
choice,4,5,13,2,24
commute,14,5,1,4,24
date,7,3,4,10,24
fact,8,6,3,7,24
general,11,6,4,3,24
generally,8,3,5,8,24
instead,5,3,6,10,24
late,6,5,5,8,24
map,16,4,3,1,24
million,9,7,4,4,24
rest,3,11,6,4,24
term,4,7,8,5,24
tu,0,0,24,0,24
worker,12,3,6,3,24
busy,0,9,7,7,23
decide,3,9,5,6,23
excellent,5,11,2,5,23
garden,13,5,4,1,23
important,10,5,5,3,23
inside,5,6,7,5,23
language,3,1,15,4,23
lausanne,0,0,23,0,23
lead,9,7,1,6,23
living,4,3,10,6,23
matter,4,8,7,4,23
middle,11,1,7,4,23
position,5,7,9,2,23
qui,0,1,21,1,23
rule,5,7,8,3,23
second,3,7,6,7,23
sense,7,3,9,4,23
site,2,4,14,3,23
summer,1,5,5,12,23
vote,8,2,5,8,23
write,9,4,4,6,23
young,4,7,8,4,23
art,14,5,2,1,22
aux,0,0,5,17,22
available,6,4,6,6,22
break,7,4,2,9,22
cat,2,3,0,17,22
complete,5,7,6,4,22
council,2,18,1,1,22
dans,0,0,21,1,22
dollar,8,5,0,9,22
drop,4,11,2,5,22
fast,1,1,13,7,22
grab,15,3,2,2,22
hate,8,7,2,5,22
photo,8,6,1,7,22
product,3,9,2,8,22
project,13,2,4,3,22
protest,20,0,0,2,22
reach,5,1,6,10,22
research,15,6,0,1,22
search,9,2,8,3,22
sydney,0,21,1,0,22
ton,4,0,11,7,22
wall,4,2,7,9,22
weekend,7,9,1,5,22
wrong,5,1,12,4,22
agree,8,5,2,6,21
avec,0,0,20,1,21
clean,3,6,4,8,21
crazy,7,5,3,6,21
difficult,0,4,13,4,21
expect,7,3,6,5,21
fly,4,13,1,3,21
hot,9,4,3,5,21
huge,5,7,6,3,21
impact,7,3,10,1,21
increase,8,6,4,3,21
literally,6,5,4,6,21
major,7,5,3,6,21
minimum,5,5,10,1,21
ne,1,0,20,0,21
period,4,8,4,5,21
personal,6,2,11,2,21
pizza,3,2,14,2,21
population,8,8,4,1,21
removal,1,2,0,18,21
require,7,4,7,3,21
social,5,4,8,4,21
unit,3,3,0,15,21
video,7,3,9,2,21
white,12,2,5,2,21
wo,7,6,4,4,21
brand,0,1,4,15,20
card,1,1,16,2,20
cette,0,0,4,16,20
common,13,3,3,1,20
construction,7,3,9,1,20
continue,8,4,2,6,20
contract,3,3,9,5,20
drink,6,2,7,5,20
hit,10,1,4,5,20
normal,6,4,5,5,20
ok,5,6,5,4,20
power,11,1,4,4,20
receive,6,3,7,4,20
rental,6,8,4,2,20
story,5,7,4,4,20
suburb,5,13,0,2,20
table,6,4,3,7,20
value,3,7,8,2,20
welcome,4,4,7,5,20
yeah,6,4,6,4,20
zero,9,6,1,4,20
american,5,3,7,4,19
avoid,4,3,6,6,19
basically,7,5,5,2,19
dunk,17,2,0,0,19
extra,0,3,7,9,19
lovely,2,12,5,0,19
lucky,4,5,7,3,19
mais,0,0,18,1,19
mod,0,2,0,17,19
nearby,4,7,3,5,19
partner,3,5,3,8,19
path,4,4,9,2,19
plenty,5,3,6,5,19
reduce,3,3,8,5,19
risk,6,4,3,6,19
step,12,2,2,3,19
strong,3,1,8,7,19
tout,0,0,18,1,19
transit,4,1,0,14,19
tree,3,11,1,4,19
wife,6,3,2,8,19
activity,5,1,8,4,18
assume,3,7,2,6,18
bunch,2,5,4,7,18
college,9,4,3,2,18
compare,4,4,6,4,18
condition,2,6,8,2,18
connect,5,3,2,8,18
decent,3,9,4,2,18
easily,6,3,6,3,18
education,5,5,5,3,18
fit,6,3,0,9,18
flat,4,2,9,3,18
ground,7,6,1,4,18
hair,2,7,2,7,18
history,7,6,3,2,18
iced,18,0,0,0,18
landlord,12,1,3,2,18
man,6,2,7,3,18
miss,4,10,2,2,18
multiple,6,1,7,4,18
museum,12,1,3,2,18
na,7,2,6,3,18
op,8,2,4,4,18
party,5,2,5,6,18
schedule,5,0,4,9,18
sont,0,0,15,3,18
source,5,4,7,2,18
throw,7,3,6,2,18
tunnel,0,0,18,0,18
unfortunately,1,7,5,5,18
union,12,0,1,5,18
wander,15,2,1,0,18
west,7,4,0,7,18
article,5,6,0,6,17
au,0,2,14,1,17
aware,1,4,8,4,17
benefit,8,4,3,2,17
border,6,2,8,1,17
cash,6,3,5,3,17
customer,0,5,2,10,17
dangerous,6,3,5,3,17
deliver,1,6,4,6,17
design,4,7,3,3,17
email,2,4,6,5,17
eye,8,5,3,1,17
flight,8,7,2,0,17
fondue,0,0,17,0,17
form,4,7,2,4,17
fund,8,4,1,4,17
green,8,6,0,3,17
honestly,5,3,4,5,17
info,7,5,3,2,17
join,1,7,5,4,17
main,1,4,8,4,17
march,4,2,6,5,17
mass,14,0,1,2,17
massachusetts,17,0,0,0,17
meat,2,4,6,5,17
medium,7,6,3,1,17
mental,4,5,1,7,17
moment,6,7,4,0,17
oh,7,3,5,2,17
regularly,5,3,6,3,17
resident,3,6,2,6,17
retire,0,1,0,16,17
simple,4,2,9,2,17
slow,3,5,4,5,17
sport,5,6,2,4,17
stock,3,9,2,3,17
tram,0,10,7,0,17
treat,6,7,0,4,17
vehicle,6,0,1,10,17
air,2,3,7,4,16
automod,0,0,0,16,16
average,3,5,5,3,16
awesome,1,8,1,6,16
bien,0,0,15,1,16
cafe,4,7,4,1,16
ceci,0,0,0,16,16
comme,0,0,16,0,16
directly,5,3,7,1,16
dr,0,11,1,4,16
exactly,3,4,5,4,16
felt,3,4,3,6,16
field,2,3,5,6,16
floor,2,5,1,8,16
flu,11,2,0,3,16
folk,6,5,1,4,16
force,4,6,2,4,16
fresh,5,5,2,4,16
heritage,0,15,1,0,16
hire,3,1,8,4,16
involve,6,3,3,4,16
january,6,4,1,5,16
lisez,0,0,0,16,16
lol,7,3,2,4,16
model,3,1,5,7,16
modrateur,0,0,0,16,16
mountain,4,8,4,0,16
national,2,4,7,3,16
news,6,2,3,5,16
official,8,2,4,2,16
pas,1,1,13,1,16
publication,0,0,0,16,16
pull,5,7,1,3,16
range,0,10,2,4,16
ready,2,1,6,7,16
regular,3,1,6,6,16
river,9,2,2,3,16
rvision,0,0,0,16,16
salary,2,2,12,0,16
section,3,8,2,3,16
seriously,4,4,5,3,16
short,2,6,5,3,16
solution,4,3,7,2,16
square,13,0,0,3,16
stage,2,4,10,0,16
sujet,0,0,0,16,16
terrible,4,2,3,7,16
true,3,1,7,5,16
anu,0,15,0,0,15
anymore,2,4,3,6,15
appear,10,4,1,0,15
approach,3,3,5,4,15
baby,4,2,2,7,15
belconnen,0,15,0,0,15
civic,0,12,0,3,15
complain,2,9,1,3,15
court,13,1,1,0,15
currently,5,1,6,3,15
des,0,0,15,0,15
development,6,8,1,0,15
employee,6,0,4,5,15
fall,5,2,1,7,15
fight,11,2,1,1,15
focus,6,4,4,1,15
kingston,0,13,0,2,15
massive,5,5,2,3,15
network,3,1,7,4,15
notice,3,3,6,3,15
opportunity,3,1,7,4,15
particularly,2,6,2,5,15
piece,2,6,3,4,15
plate,0,1,8,6,15
pool,4,7,0,4,15
poor,3,6,4,2,15
practice,1,8,1,5,15
prepare,1,2,8,4,15
remain,4,4,2,5,15
resource,9,2,2,2,15
sale,2,1,0,12,15
seat,1,4,8,2,15
sick,8,1,2,4,15
straight,4,8,1,2,15
study,5,0,10,0,15
tend,3,2,7,3,15
thanks,3,2,8,2,15
tire,5,3,2,5,15
tour,6,3,6,0,15
track,4,5,4,2,15
transportation,3,0,7,5,15
waste,7,1,2,5,15
wish,2,2,6,5,15
yarn,0,1,4,10,15
affordable,6,3,3,2,14
application,2,3,6,3,14
appointment,1,9,2,2,14
bag,2,2,2,8,14
bed,6,1,0,7,14
beer,0,4,4,6,14
certain,3,6,3,2,14
chance,5,1,5,3,14
claim,3,8,1,2,14
covid,4,3,1,6,14
difference,4,1,6,3,14
donate,10,0,0,4,14
east,6,1,1,6,14
exist,2,5,3,4,14
explore,6,2,6,0,14
extremely,4,0,4,6,14
fix,4,4,2,4,14
foot,4,3,2,5,14
fyshwick,0,14,0,0,14
genve,0,0,14,0,14
gungahlin,0,14,0,0,14
heat,6,2,1,5,14
hospital,5,3,0,6,14
hotel,4,1,5,4,14
immediately,6,1,3,4,14
individual,3,5,1,5,14
interview,2,1,3,8,14
land,4,5,2,3,14
lease,8,1,5,0,14
legal,8,0,3,3,14
manage,3,2,6,3,14
non,1,3,8,2,14
organization,9,0,4,1,14
pepper,1,2,7,4,14
pie,0,13,1,0,14
potential,3,3,6,2,14
process,2,5,2,5,14
professional,1,5,4,4,14
recommendation,0,5,5,4,14
register,0,4,5,5,14
result,5,2,4,3,14
resume,1,0,0,13,14
ride,4,5,3,2,14
season,2,6,2,4,14
spring,6,3,0,5,14
sunday,3,1,5,5,14
teacher,3,1,7,3,14
volunteer,5,3,0,6,14
vous,0,0,11,3,14
accord,3,0,5,5,13
actual,4,1,2,6,13
ai,1,0,9,3,13
annoy,1,2,7,3,13
approve,1,0,1,11,13
awful,2,6,2,3,13
bet,4,4,2,3,13
bird,4,4,0,5,13
boy,7,0,1,5,13
camera,2,1,6,4,13
clearly,3,4,4,2,13
data,5,1,4,3,13
dealership,2,0,0,11,13
decade,5,5,1,2,13
degree,2,3,5,3,13
demand,3,1,7,2,13
dinner,2,6,1,4,13
direct,6,4,1,2,13
dont,2,2,4,5,13
equipment,2,2,3,6,13
fail,5,3,1,4,13
fantastic,1,9,2,1,13
forget,5,1,1,6,13
friendly,3,7,2,1,13
funding,7,2,1,3,13
guess,1,5,5,2,13
harvard,12,0,1,0,13
hell,5,1,3,4,13
human,8,2,2,1,13
lack,2,5,2,4,13
left,2,5,2,4,13
limit,2,5,4,2,13
link,4,3,4,2,13
min,3,3,6,1,13
neighborhood,8,0,3,2,13
net,9,0,3,1,13
obviously,1,1,5,6,13
ontario,0,0,0,13,13
organisation,0,1,12,0,13
page,3,6,1,3,13
personally,0,1,6,6,13
shopping,0,7,5,1,13
skill,2,2,3,6,13
stick,0,2,6,5,13
suck,6,3,2,2,13
sun,9,2,1,1,13
tip,7,5,1,0,13
totally,6,3,0,4,13
transfer,0,1,4,8,13
wage,8,2,3,0,13
warm,7,2,2,2,13
weather,2,3,1,7,13
woden,0,13,0,0,13
worry,4,4,0,5,13
accessible,4,4,1,3,12
address,3,2,4,3,12
agency,3,2,7,0,12
apparently,1,2,4,5,12
ave,7,1,0,4,12
bakery,1,5,3,3,12
beautiful,2,4,4,2,12
bin,3,1,1,7,12
bother,2,3,4,3,12
box,4,3,1,4,12
canadian,0,0,0,12,12
capital,0,11,0,1,12
chinese,9,0,2,1,12
clinic,2,6,2,2,12
completely,1,4,3,4,12
cop,3,2,2,5,12
corner,3,4,1,4,12
dentist,1,9,2,0,12
dickson,0,12,0,0,12
direction,1,2,7,2,12
electric,6,2,3,1,12
finally,2,3,5,2,12
finish,2,6,3,1,12
flow,4,2,6,0,12
furniture,0,5,3,4,12
future,0,7,4,1,12
gon,5,1,4,2,12
hall,8,2,1,1,12
holiday,0,9,3,0,12
income,2,5,4,1,12
interesting,2,4,2,4,12
kill,6,2,3,1,12
lay,4,5,1,2,12
loud,1,1,3,7,12
meal,2,4,3,3,12
ou,0,0,12,0,12
outdoor,1,1,4,6,12
picture,3,4,4,1,12
president,8,1,0,3,12
purchase,1,4,4,3,12
quickly,5,0,5,2,12
quiet,1,7,0,4,12
rail,5,3,0,4,12
rat,9,0,0,3,12
record,5,1,3,3,12
refuse,1,3,4,4,12
registration,0,9,2,1,12
repair,5,2,1,4,12
soon,1,1,4,6,12
special,5,2,2,3,12
style,1,2,5,4,12
tesla,6,0,6,0,12
useful,0,2,10,0,12
various,2,3,4,3,12
yesterday,4,4,2,2,12
administration,8,0,0,3,11
amazing,1,4,2,4,11
apart,2,3,5,1,11
attend,3,2,5,1,11
begin,2,4,1,4,11
blue,7,2,1,1,11
body,3,4,3,1,11
canton,1,0,10,0,11
chat,2,1,5,3,11
cheese,0,1,10,0,11
church,5,6,0,0,11
citizen,3,1,5,2,11
condo,4,0,0,7,11
control,1,0,5,5,11
decision,3,6,2,0,11
despite,3,4,2,2,11
driving,2,0,4,5,11
dry,2,4,2,3,11
employer,2,3,2,4,11
estate,3,3,0,5,11
extend,4,2,2,3,11
fairly,1,4,2,4,11
farmer,1,1,0,9,11
figure,4,3,0,4,11
function,7,1,2,1,11
grand,1,1,8,1,11
grass,0,10,0,1,11
grocery,3,3,3,2,11
helpful,2,3,1,5,11
ignore,4,2,1,4,11
illegal,8,0,1,2,11
impossible,1,1,6,3,11
kick,4,4,0,3,11
kinda,3,4,3,1,11
lesson,2,5,0,4,11
listen,3,2,3,3,11
management,2,4,5,0,11
mark,4,1,4,2,11
menu,3,1,2,5,11
mix,4,3,3,1,11
nation,5,1,3,2,11
neighbor,10,0,1,0,11
noise,1,2,2,6,11
patient,2,3,2,4,11
pic,7,0,0,4,11
pressure,1,2,4,4,11
previous,1,3,2,5,11
quote,1,4,2,4,11
random,2,3,1,5,11
role,2,5,2,2,11
roof,0,7,0,4,11
round,3,2,2,4,11
sad,3,1,5,2,11
saturday,2,5,2,2,11
security,3,0,5,3,11
servette,0,0,11,0,11
shift,1,6,1,3,11
ski,2,1,5,3,11
society,1,1,3,6,11
specifically,3,4,2,2,11
standard,3,3,2,3,11
suppose,3,4,2,2,11
sweet,3,5,1,2,11
target,5,3,0,3,11
tariff,2,0,0,9,11
team,4,5,0,2,11
thank,5,1,3,2,11
thought,4,1,4,2,11
thread,3,3,0,5,11
total,5,2,3,1,11
waitlist,0,1,0,10,11
wonder,2,6,1,2,11
accept,1,4,3,2,10
additionally,4,1,2,3,10
ahead,2,5,3,0,10
america,7,0,0,3,10
arrest,8,1,1,0,10
aussi,0,0,10,0,10
beacon,8,0,0,2,10
bell,0,8,0,2,10
belmont,10,0,0,0,10
bilingual,1,0,4,5,10
black,3,3,2,2,10
carry,3,0,4,3,10
catch,3,4,0,3,10
closer,4,3,0,3,10
comment,1,4,3,2,10
connection,1,4,2,3,10
conversation,2,1,3,4,10
criminal,8,0,0,2,10
crowd,6,1,3,0,10
cultural,2,3,4,1,10
current,4,5,0,1,10
cycle,2,1,6,1,10
daycare,0,1,0,9,10
department,5,2,0,3,10
deposit,3,2,4,1,10
develop,0,3,5,2,10
effort,2,0,5,3,10
egg,4,4,1,1,10
encourage,4,3,3,0,10
enforcement,5,0,2,3,10
europe,3,1,6,0,10
exact,1,0,3,6,10
expand,0,3,2,5,10
facebook,1,0,3,6,10
farm,1,2,0,7,10
firm,1,5,1,3,10
fully,2,5,1,2,10
gas,2,4,0,4,10
girl,2,3,3,2,10
glass,6,2,2,0,10
grant,6,3,1,0,10
hey,3,0,3,4,10
hike,2,1,4,3,10
homeless,3,0,1,6,10
indirect,10,0,0,0,10
insane,7,0,1,2,10
item,1,2,3,4,10
knowledge,3,3,3,1,10
kraft,10,0,0,0,10
license,2,5,1,2,10
luxury,2,1,5,2,10
maintain,6,1,2,1,10
manager,1,3,0,6,10
medical,3,5,0,2,10
mme,0,0,10,0,10
modern,1,6,2,1,10
neighbourhood,0,0,1,9,10
odd,2,3,1,4,10
okay,2,2,3,3,10
particular,1,2,3,4,10
plane,4,1,4,1,10
pond,9,1,0,0,10
priority,1,4,1,4,10
produce,1,1,0,8,10
protect,2,1,4,3,10
protection,5,2,1,2,10
pub,1,5,4,0,10
raise,2,4,2,2,10
recent,3,2,2,3,10
relate,5,2,2,1,10
requirement,2,3,3,2,10
rideau,0,0,0,10,10
roll,4,1,1,4,10
roommate,7,0,0,3,10
senior,6,4,0,0,10
ship,1,0,4,5,10
shot,5,3,1,1,10
significant,4,2,2,2,10
skate,5,1,1,3,10
sleep,3,4,0,3,10
son,0,2,4,4,10
speed,0,3,3,4,10
spray,1,1,7,1,10
statue,9,0,0,1,10
studio,4,2,3,1,10
suggestion,0,5,1,4,10
teach,5,2,1,2,10
tech,3,3,3,1,10
temperature,7,3,0,0,10
tool,2,4,1,3,10
tough,2,1,3,4,10
tv,1,1,0,8,10
uber,2,3,4,1,10
urban,5,1,1,3,10
vegan,0,4,6,0,10
weight,1,7,1,1,10
willing,6,1,2,1,10
wine,1,3,5,1,10
word,6,1,2,1,10
wu,10,0,0,0,10
absolute,2,1,2,4,9
academic,0,5,3,1,9
active,2,3,4,0,9
additional,3,3,1,2,9
adult,2,2,4,1,9
afford,1,4,2,2,9
amaze,1,4,1,3,9
animal,1,1,1,6,9
arrive,0,1,4,4,9
bowl,8,0,0,1,9
burger,1,7,1,0,9
cancel,2,3,0,4,9
central,5,1,1,2,9
chair,0,2,5,2,9
clear,2,3,2,2,9
coast,3,6,0,0,9
complex,0,4,4,1,9
counter,3,1,0,5,9
crap,2,1,1,5,9
crisis,1,2,2,4,9
crossing,0,4,5,0,9
damage,7,0,0,2,9
display,2,3,2,2,9
double,4,4,0,1,9
elevator,1,2,5,1,9
enter,2,2,4,1,9
entirely,1,6,1,1,9
evening,1,1,3,4,9
exhibit,7,1,1,0,9
exit,2,2,2,3,9
fair,3,2,2,2,9
faster,2,5,2,0,9
financial,1,6,1,1,9
friday,3,4,1,1,9
glad,2,1,1,5,9
god,3,1,1,4,9
highly,4,0,1,4,9
immigration,8,0,0,1,9
improve,1,1,6,1,9
jonction,0,0,9,0,9
jump,3,2,3,1,9
lady,1,3,2,3,9
loss,2,4,1,2,9
mainly,1,1,4,3,9
mall,2,7,0,0,9
measure,5,0,2,2,9
men,2,0,6,1,9
metrolinx,0,0,0,9,9
moins,0,0,9,0,9
montreux,0,0,9,0,9
music,1,1,4,3,9
officer,4,1,1,3,9
paquis,0,0,9,0,9
payment,3,1,2,3,9
pedestrian,0,5,4,0,9
port,7,0,2,0,9
present,1,1,4,3,9
properly,1,2,2,4,9
prosecutor,9,0,0,0,9
province,0,0,0,9,9
queer,1,0,0,8,9
rain,2,4,2,1,9
reading,1,2,0,6,9
request,3,2,2,2,9
resolve,1,4,1,3,9
rush,1,2,3,3,9
se,0,0,9,0,9
sector,1,4,4,0,9
select,1,0,7,1,9
shake,1,4,0,4,9
shame,4,1,1,3,9
smell,0,5,1,3,9
specie,6,3,0,0,9
spice,0,1,4,4,9
tap,1,5,0,3,9
taste,6,2,0,1,9
temp,0,2,7,0,9
textile,6,0,0,3,9
toronto,1,0,0,8,9
tpg,0,0,9,0,9
tre,0,0,8,1,9
tricky,0,1,4,4,9
trs,0,0,9,0,9
village,0,1,8,0,9
visitor,8,1,0,0,9
weird,2,3,0,4,9
wind,4,1,4,0,9
ability,2,4,1,1,8
admin,3,2,3,0,8
admit,3,0,1,4,8
afternoon,2,5,1,0,8
agent,1,1,5,1,8
alternative,1,2,1,4,8
apps,1,0,5,2,8
artist,5,1,1,1,8
attempt,3,0,0,5,8
background,1,1,3,3,8
barely,2,2,1,3,8
bay,4,2,0,2,8
bear,1,2,3,2,8
bedroom,0,4,2,2,8
blow,2,3,2,1,8
charles,8,0,0,0,8
comedian,1,0,0,7,8
comfortable,1,4,2,1,8
commit,2,2,1,3,8
commonly,6,0,1,1,8
confirm,0,2,5,1,8
congestion,1,0,7,0,8
corporate,4,2,2,0,8
couch,0,6,0,2,8
cream,4,3,0,1,8
debt,1,1,0,6,8
dedicate,4,0,1,3,8
dental,0,7,1,0,8
die,3,1,0,4,8
dish,0,3,5,0,8
donation,5,1,0,2,8
doubt,2,1,3,2,8
dozen,3,3,1,1,8
drug,0,1,2,5,8
economy,0,1,3,4,8
ed,2,0,0,6,8
essentially,2,4,1,1,8
evidence,2,4,0,2,8
exam,7,1,0,0,8
expense,3,3,2,0,8
express,1,0,4,3,8
factor,2,1,3,2,8
fan,4,1,0,3,8
filter,1,0,2,5,8
forest,5,0,3,0,8
freedom,4,1,2,1,8
frozen,3,2,1,2,8
gear,4,1,0,3,8
graduate,2,0,5,1,8
guarantee,1,2,2,3,8
hang,1,1,3,3,8
hat,5,1,0,2,8
husband,3,2,1,2,8
incredibly,3,3,1,1,8
industry,0,1,3,4,8
infrastructure,1,3,3,1,8
interested,1,1,4,2,8
internet,0,0,5,3,8
investment,3,2,2,1,8
island,6,2,0,0,8
italian,2,3,3,0,8
jam,0,0,7,1,8
japanese,0,5,3,0,8
key,2,0,4,2,8
largely,1,6,1,0,8
laundry,2,1,0,5,8
letter,2,2,4,0,8
lobster,8,0,0,0,8
longer,1,6,0,1,8
majura,0,8,0,0,8
meeting,3,2,2,1,8
mess,2,2,1,3,8
meter,2,0,3,3,8
migros,0,0,8,0,8
montreal,0,0,0,8,8
movie,3,0,3,2,8
narrow,2,1,2,3,8
native,6,0,1,1,8
nearly,1,2,1,4,8
normally,0,2,4,2,8
opinion,0,3,2,3,8
overall,3,1,4,0,8
package,1,3,0,4,8
participate,4,2,2,0,8
perfectly,1,1,6,0,8
plant,2,3,1,2,8
potentially,1,3,2,2,8
proper,2,2,1,3,8
purpose,2,0,4,2,8
quand,0,0,8,0,8
quick,1,2,3,2,8
reality,4,1,2,1,8
reasonable,0,4,1,3,8
reddit,2,1,2,3,8
reliable,1,1,3,3,8
rely,1,3,2,2,8
response,5,2,1,0,8
rich,4,0,3,1,8
safety,1,2,1,4,8
screw,3,4,0,1,8
separate,4,0,2,2,8
shock,2,3,0,3,8
shoot,4,1,2,1,8
simply,3,0,2,3,8
slightly,2,1,1,4,8
sort,3,2,1,2,8
sq,7,0,0,1,8
stadium,1,7,0,0,8
stair,0,0,0,8,8
strike,6,2,0,0,8
stupid,3,2,1,2,8
succeed,7,0,0,1,8
summernats,0,8,0,0,8
ta,2,0,6,0,8
te,0,0,8,0,8
tenant,3,2,1,2,8
text,1,1,5,1,8
traditional,0,4,4,0,8
trash,6,0,1,1,8
usual,4,2,0,2,8
victim,5,3,0,0,8
visible,5,0,2,1,8
weekday,3,1,1,3,8
accommodation,0,1,4,2,7
advise,1,3,3,0,7
aggressive,3,1,2,1,7
alors,0,0,7,0,7
apple,3,0,2,2,7
appreciate,0,4,1,2,7
arrow,0,4,2,1,7
assault,6,0,0,1,7
asshole,4,0,2,1,7
attach,5,0,0,2,7
attention,2,2,2,1,7
australian,0,6,1,0,7
authority,3,4,0,0,7
availability,0,0,5,2,7
avoir,0,0,6,1,7
beginner,2,3,2,0,7
birthday,0,3,3,1,7
blame,2,1,0,4,7
branch,6,1,0,0,7
brisbane,0,7,0,0,7
brookline,7,0,0,0,7
brutal,2,2,2,1,7
byward,0,0,0,7,7
cake,1,6,0,0,7
carouge,0,0,7,0,7
catholic,5,1,0,1,7
cela,0,0,7,0,7
chef,3,0,3,1,7
chicken,3,3,1,0,7
chip,0,6,0,1,7
christmas,0,2,3,2,7
clothes,2,0,1,4,7
commuter,5,1,1,0,7
complaint,3,2,0,2,7
concert,0,0,5,2,7
consideration,0,1,5,1,7
context,2,1,2,2,7
convenient,2,2,2,1,7
cook,1,3,1,2,7
creative,1,1,2,3,7
croissant,0,0,7,0,7
cup,3,2,2,0,7
cute,1,3,3,0,7
cyclist,1,0,5,1,7
daily,4,2,0,1,7
damn,4,1,1,1,7
dead,2,1,0,4,7
december,0,2,2,3,7
delivery,0,1,5,1,7
developer,2,2,1,2,7
digitec,0,0,7,0,7
distance,1,1,2,3,7
document,1,1,4,1,7
economic,3,1,0,3,7
efficient,2,2,2,1,7
emergency,0,0,1,6,7
equal,4,0,1,2,7
european,0,1,4,2,7
fait,0,0,7,0,7
fancy,1,3,3,0,7
fare,0,1,3,3,7
fault,2,3,0,2,7
fear,2,2,0,3,7
female,0,3,2,2,7
final,0,2,4,1,7
firework,0,3,3,1,7
forward,3,0,1,3,7
frankly,1,0,4,2,7
frequent,1,0,2,4,7
frequently,2,1,1,3,7
garage,0,2,3,2,7
generation,2,1,3,1,7
genuinely,4,2,0,1,7
george,1,0,3,3,7
giant,2,2,0,3,7
girlfriend,2,1,4,0,7
golf,2,2,1,2,7
height,1,0,2,4,7
hide,3,2,1,1,7
highway,1,2,3,1,7
hockey,0,3,2,2,7
hole,3,3,0,1,7
id,0,1,6,0,7
indoor,0,3,0,4,7
inner,0,7,0,0,7
intel,0,7,0,0,7
io,0,0,7,0,7
juste,0,0,7,0,7
kanata,0,0,0,7,7
kitchen,1,4,1,1,7
lansdowne,0,0,0,7,7
lawn,1,6,0,0,7
liberal,3,1,1,2,7
library,3,1,1,2,7
machine,0,3,3,1,7
maintenance,3,3,0,1,7
melbourne,0,7,0,0,7
mfa,7,0,0,0,7
mistake,2,2,2,1,7
mit,7,0,0,0,7
negotiate,3,3,0,1,7
obvious,2,4,0,1,7
ocdsb,0,0,0,7,7
platform,1,0,4,2,7
pocket,2,2,3,0,7
policy,5,1,1,0,7
pop,1,4,1,1,7
possibly,3,1,1,2,7
presto,0,0,0,7,7
pricing,1,3,0,3,7
primary,2,2,1,2,7
promise,4,0,1,2,7
prove,2,1,3,1,7
ramen,0,3,4,0,7
rating,5,1,0,1,7
relative,1,1,4,1,7
relatively,1,3,3,0,7
replace,1,4,1,1,7
respect,2,1,3,1,7
respond,1,3,2,1,7
rgie,0,0,7,0,7
ridiculous,3,2,0,2,7
salt,1,0,0,6,7
scene,0,2,1,4,7
science,3,0,4,0,7
scream,1,3,1,2,7
screen,1,1,2,3,7
seek,1,4,1,1,7
shoe,1,1,2,3,7
sidewalk,4,0,2,1,7
solid,2,2,0,3,7
solve,2,0,4,1,7
speaker,0,1,3,3,7
storm,2,1,0,4,7
stress,1,3,2,1,7
submission,0,6,1,0,7
suisse,0,0,7,0,7
supply,3,2,0,2,7
surprised,2,1,3,1,7
switch,0,0,4,3,7
symptom,5,1,1,0,7
taxi,0,1,6,0,7
terminal,0,4,1,2,7
thursday,2,3,0,2,7
tourism,6,0,1,0,7
tourist,0,3,2,2,7
trade,1,1,1,4,7
truck,3,1,1,2,7
twice,1,4,1,1,7
uk,0,2,2,3,7
useless,0,0,6,1,7
veggie,2,1,2,2,7
ville,0,0,6,1,7
votre,0,0,6,1,7
wake,2,4,0,1,7
wave,1,0,5,1,7
window,2,2,1,2,7
wonderful,4,0,0,3,7
working,1,1,5,0,7
yell,3,2,0,2,7
yellow,2,0,5,0,7
achieve,3,2,1,0,6
advance,1,2,3,0,6
agreement,2,2,0,2,6
al,0,0,5,1,6
allston,6,0,0,0,6
angry,6,0,0,0,6
anne,0,0,5,1,6
anyways,0,0,1,5,6
applicant,0,3,1,2,6
april,3,0,2,1,6
assist,2,2,1,1,6
assistant,1,1,3,1,6
association,3,1,1,1,6
attorney,6,0,0,0,6
australia,0,6,0,0,6
authentic,2,0,3,1,6
bain,0,0,6,0,6
beach,2,4,0,0,6
belco,0,6,0,0,6
bicycle,0,3,3,0,6
blend,0,6,0,0,6
boot,2,2,1,1,6
bottle,0,2,2,2,6
brain,0,0,1,5,6
brew,4,1,0,1,6
broken,1,0,3,2,6
brother,2,1,3,0,6
buddy,2,0,3,1,6
canal,2,0,1,3,6
career,0,1,4,1,6
carling,0,0,0,6,6
cave,0,2,4,0,6
certainly,1,1,1,3,6
china,2,0,2,2,6
chocolate,1,1,4,0,6
classic,2,1,2,1,6
climate,4,1,1,0,6
coat,3,1,2,0,6
coin,0,1,4,1,6
cole,0,4,1,1,6
colour,0,5,0,1,6
committee,4,2,0,0,6
competition,1,1,3,1,6
concrete,1,3,0,2,6
confidence,1,3,0,2,6
constantly,1,1,1,3,6
consultation,0,5,1,0,6
convert,2,3,1,0,6
convince,1,1,1,3,6
cornavin,0,0,6,0,6
correctly,1,2,2,1,6
cough,3,0,0,3,6
count,2,1,2,1,6
crack,1,2,0,3,6
cummings,0,1,0,5,6
curious,4,2,0,0,6
currency,1,0,5,0,6
curriculum,0,1,2,3,6
da,0,5,1,0,6
dance,0,1,0,5,6
death,3,0,2,1,6
delay,3,1,1,1,6
destroy,3,1,2,0,6
differently,1,0,1,4,6
dm,2,0,1,3,6
drain,0,5,0,1,6
draw,2,1,1,2,6
dress,2,0,1,3,6
earn,1,2,3,0,6
effect,2,2,1,1,6
election,2,2,0,2,6
elon,6,0,0,0,6
england,6,0,0,0,6
ensure,2,2,1,1,6
equivalent,4,0,2,0,6
estimate,1,1,1,3,6
euro,0,3,3,0,6
evap,0,6,0,0,6
eve,0,1,5,0,6
exercise,0,2,1,3,6
expat,0,0,5,1,6
facility,3,2,1,0,6
favourite,0,2,2,2,6
february,0,2,1,3,6
feeling,1,0,2,3,6
fellow,0,2,3,1,6
fenway,6,0,0,0,6
ferney,0,0,6,0,6
file,1,0,2,3,6
finance,0,2,3,1,6
fish,0,5,0,1,6
flexible,1,2,2,1,6
forecast,1,3,0,2,6
freeze,3,0,2,1,6
fruit,0,3,0,3,6
fucking,4,2,0,0,6
gen,1,0,5,0,6
gold,0,0,6,0,6
gravel,1,5,0,0,6
guide,3,2,0,1,6
handle,1,1,3,1,6
heavy,2,1,2,1,6
hi,1,0,4,1,6
horrible,0,3,1,2,6
hurt,4,1,1,0,6
idk,1,2,0,3,6
image,2,2,1,1,6
imo,1,3,1,1,6
impression,3,1,2,0,6
instal,2,0,0,4,6
institution,2,3,1,0,6
internship,0,1,5,0,6
intersection,2,0,3,1,6
joke,1,0,3,2,6
journey,2,1,2,1,6
justice,6,0,0,0,6
justify,2,1,2,1,6
keen,2,4,0,0,6
king,3,0,0,3,6
lab,3,0,0,3,6
label,2,1,2,1,6
leadership,1,3,1,1,6
leaf,0,1,1,4,6
lexington,6,0,0,0,6
licence,0,6,0,0,6
load,3,2,1,0,6
locally,2,1,1,2,6
locate,2,2,1,1,6
lock,2,1,0,3,6
london,0,1,4,1,6
loyer,0,0,6,0,6
mail,1,1,4,0,6
majority,1,0,2,3,6
malden,6,0,0,0,6
master,1,0,5,0,6
mbta,6,0,0,0,6
memory,1,4,1,0,6
mile,6,0,0,0,6
mira,6,0,0,0,6
mt,3,3,0,0,6
mud,0,6,0,0,6
mushroom,2,2,2,0,6
nature,2,0,2,2,6
necessary,0,3,2,1,6
negative,1,0,4,1,6
noodle,0,4,1,1,6
nsw,0,6,0,0,6
occasionally,1,2,0,3,6
ont,0,0,6,0,6
operate,1,2,0,3,6
opposite,0,2,3,1,6
orange,3,0,0,3,6
original,2,2,1,1,6
pain,2,0,2,2,6
payer,0,0,6,0,6
personne,0,0,6,0,6
pet,0,2,0,4,6
peut,0,0,5,1,6
physio,0,3,0,3,6
pickup,1,0,2,3,6
pitch,2,0,0,4,6
political,3,1,2,0,6
premium,2,3,1,0,6
proud,4,1,1,0,6
pt,1,0,0,5,6
rare,0,1,3,2,6
rarely,1,1,2,2,6
rd,2,2,0,2,6
refer,2,3,1,0,6
regard,1,1,4,0,6
regardless,2,2,0,2,6
region,1,1,1,3,6
regional,0,3,1,2,6
relevant,1,3,0,2,6
reply,1,1,2,2,6
republican,5,0,0,1,6
reverse,2,4,0,0,6
rgies,0,0,6,0,6
rock,1,3,1,1,6
roughly,3,1,1,1,6
row,1,1,0,4,6
salesperson,0,0,0,6,6
selection,1,3,0,2,6
self,1,3,2,0,6
senator,4,1,0,1,6
sidebar,6,0,0,0,6
smile,3,2,1,0,6
soft,0,3,3,0,6
southern,2,3,0,1,6
specially,0,0,4,2,6
spider,0,6,0,0,6
split,3,1,2,0,6
steak,0,3,1,2,6
stroller,0,0,6,0,6
sub,0,1,4,1,6
subaru,0,0,0,6,6
subway,5,0,0,1,6
successful,0,1,0,5,6
surround,1,2,2,1,6
sushi,0,0,6,0,6
tall,0,4,1,1,6
tc,0,1,5,0,6
tea,2,4,0,0,6
teen,2,2,1,1,6
thinking,2,2,2,0,6
thousand,2,1,1,2,6
threaten,2,0,2,2,6
tiny,1,2,1,2,6
tomato,1,0,0,5,6
tower,2,1,0,3,6
townhouse,0,2,0,4,6
treatment,2,3,0,1,6
trouble,1,1,1,3,6
tuesday,1,2,0,3,6
tuition,3,2,1,0,6
underground,0,1,3,2,6
understanding,2,4,0,0,6
unlike,3,3,0,0,6
user,1,2,1,2,6
van,1,2,3,0,6
version,0,4,2,0,6
wan,2,1,2,1,6
war,1,1,2,2,6
warn,1,3,1,1,6
western,5,0,0,1,6
wild,2,2,0,2,6
win,4,1,1,0,6
wing,3,1,0,2,6
wise,0,1,4,1,6
yard,1,3,0,2,6
academically,1,0,1,3,5
actively,3,0,1,1,5
addition,4,1,0,0,5
admission,1,1,2,1,5
adopt,0,0,1,4,5
advantage,0,2,1,2,5
affect,2,3,0,0,5
afraid,0,1,3,1,5
alternatively,2,1,1,1,5
announce,0,2,2,1,5
appropriate,1,2,0,2,5
argue,1,1,2,1,5
asian,0,4,0,1,5
attack,4,0,1,0,5
bains,0,0,5,0,5
bake,0,0,3,2,5
ball,1,2,0,2,5
behaviour,0,1,4,0,5
bia,0,0,0,5,5
billionaire,5,0,0,0,5
braddon,0,5,0,0,5
brasserie,0,0,5,0,5
bread,0,0,4,1,5
breath,2,1,0,2,5
broad,2,2,0,1,5
brown,1,4,0,0,5
caf,0,0,5,0,5
canberrans,0,5,0,0,5
cancer,5,0,0,0,5
candlepin,5,0,0,0,5
cap,4,1,0,0,5
carleton,0,0,0,5,5
casual,0,1,2,2,5
category,1,2,0,2,5
cbd,0,5,0,0,5
cbp,5,0,0,0,5
ceiling,2,0,1,2,5
centretown,0,0,0,5,5
chart,1,0,3,1,5
chestnut,3,0,2,0,5
citizenship,2,1,1,1,5
civil,3,0,2,0,5
commercial,2,0,2,1,5
commission,0,1,2,2,5
comparison,2,3,0,0,5
competitive,0,1,4,0,5
congrats,4,0,0,1,5
coworkers,3,1,1,0,5
credit,1,0,1,3,5
crush,1,3,1,0,5
culture,0,1,3,1,5
curly,2,0,0,3,5
dark,1,1,0,3,5
davis,5,0,0,0,5
dealer,2,0,2,1,5
deep,1,2,0,2,5
delicious,1,2,0,2,5
democrat,5,0,0,0,5
description,2,0,1,2,5
detour,2,1,1,1,5
discover,2,0,1,2,5
discuss,0,1,2,2,5
divert,2,0,1,2,5
donut,5,0,0,0,5
dossier,0,0,5,0,5
drag,3,0,0,2,5
duration,1,1,3,0,5
edge,3,1,0,1,5
employ,2,1,1,1,5
employment,0,1,2,2,5
energy,1,3,0,1,5
enforce,2,0,1,2,5
entertainment,1,1,1,2,5
entre,0,0,4,1,5
entry,2,0,2,1,5
environment,4,0,1,0,5
es,0,0,5,0,5
essential,1,4,0,0,5
eu,0,0,4,1,5
everybody,0,4,0,1,5
exchange,0,1,4,0,5
excite,1,2,0,2,5
exemple,0,0,3,2,5
fake,1,2,1,1,5
famous,1,2,1,1,5
fascism,5,0,0,0,5
feed,1,3,1,0,5
fell,3,2,0,0,5
flag,2,0,1,2,5
frais,0,0,5,0,5
franc,0,0,5,0,5
frequency,1,1,1,2,5
frontaliers,0,0,5,0,5
fuel,1,2,1,1,5
funny,1,2,2,0,5
gare,0,0,5,0,5
gate,4,0,1,0,5
gender,3,1,0,1,5
glebe,0,0,0,5,5
glove,5,0,0,0,5
grade,2,0,0,3,5
growth,2,1,1,1,5
haha,1,3,1,0,5
hassle,1,0,3,1,5
honest,0,2,3,0,5
hook,1,0,1,3,5
hop,1,0,0,4,5
hopefully,1,4,0,0,5
host,3,1,0,1,5
humidity,2,3,0,0,5
hunt,0,1,2,2,5
hut,0,3,0,2,5
identify,2,1,1,1,5
im,1,2,1,1,5
inch,3,1,0,1,5
independent,0,2,2,1,5
initial,0,3,0,2,5
inspire,0,2,2,1,5
instagram,2,1,1,1,5
instance,1,1,2,1,5
insulation,3,2,0,0,5
integrate,0,0,5,0,5
intend,1,1,2,1,5
interior,0,0,0,5,5
introduce,2,0,3,0,5
iphone,0,1,2,2,5
jacket,2,0,2,1,5
judge,2,0,1,2,5
july,2,1,0,2,5
kg,0,0,3,2,5
kindergarten,0,0,3,2,5
landsdowne,0,0,0,5,5
laptop,0,0,5,0,5
lately,3,1,1,0,5
lawyer,1,0,4,0,5
league,2,1,0,2,5
lifestyle,0,2,3,0,5
lonsdale,0,5,0,0,5
loop,1,2,0,2,5
loudly,0,1,1,3,5
lrt,0,0,0,5,5
lunch,0,4,0,1,5
mayor,2,0,0,3,5
medicare,0,5,0,0,5
membership,2,0,0,3,5
metal,1,1,1,2,5
mexican,1,2,0,2,5
mid,0,2,1,2,5
midnight,2,1,2,0,5
minority,3,1,0,1,5
monday,2,2,0,1,5
monster,3,2,0,0,5
mont,0,0,5,0,5
natural,2,2,0,1,5
nazi,5,0,0,0,5
newbury,5,0,0,0,5
operation,4,0,0,1,5
org,3,0,2,0,5
orleans,1,0,0,4,5
outdoors,2,0,1,2,5
pair,2,0,2,1,5
paper,3,0,0,2,5
parfois,0,0,5,0,5
parkway,1,1,0,3,5
patch,2,2,1,0,5
pathology,0,5,0,0,5
patrol,0,2,0,3,5
peak,0,3,2,0,5
permit,1,0,3,1,5
peux,0,0,5,0,5
phd,1,2,2,0,5
photograph,3,1,0,1,5
pin,4,0,1,0,5
pipe,0,1,2,2,5
pizze,0,0,5,0,5
plainpalais,0,0,5,0,5
plow,0,1,0,4,5
politics,2,1,2,0,5
poorly,3,1,0,1,5
pork,1,1,0,3,5
portion,2,0,3,0,5
positive,2,0,1,2,5
ppl,1,1,2,1,5
precinct,0,5,0,0,5
press,2,2,1,0,5
pretend,2,0,1,2,5
prior,1,2,1,1,5
pro,1,2,1,1,5
professor,2,3,0,0,5
profit,3,0,0,2,5
progress,1,2,0,2,5
promotion,0,4,0,1,5
propose,1,1,3,0,5
pump,1,2,0,2,5
queanbeyan,0,5,0,0,5
radon,5,0,0,0,5
raku,0,5,0,0,5
realistic,1,2,1,1,5
recycle,4,1,0,0,5
reference,0,2,1,2,5
reflect,1,2,0,2,5
refund,0,2,1,2,5
regina,4,0,0,1,5
relationship,2,0,2,1,5
remind,1,1,1,2,5
repeat,0,0,1,4,5
represent,2,0,3,0,5
reservation,3,0,2,0,5
resist,4,0,0,1,5
retail,0,1,0,4,5
reward,3,0,1,1,5
rip,1,1,0,3,5
rise,3,1,1,0,5
roller,0,0,0,5,5
rugby,1,1,0,3,5
salaire,0,0,5,0,5
sauce,2,0,1,2,5
saving,3,2,0,0,5
scrap,3,2,0,0,5
scratch,2,2,0,1,5
sen,0,0,1,4,5
serve,2,1,2,0,5
session,1,2,0,2,5
setting,0,4,1,0,5
settle,0,4,1,0,5
shelter,1,0,1,3,5
shore,5,0,0,0,5
smoke,4,0,1,0,5
soit,0,0,5,0,5
soleil,0,0,5,0,5
souvent,0,0,5,0,5
specialist,0,5,0,0,5
spread,4,0,1,0,5
statement,3,1,0,1,5
status,1,1,3,0,5
steal,2,1,1,1,5
subject,0,3,2,0,5
submit,2,0,2,1,5
success,1,0,2,2,5
suis,0,0,5,0,5
sunny,0,3,2,0,5
supportive,1,1,0,3,5
surely,1,3,1,0,5
surtout,0,0,3,2,5
survive,1,1,3,0,5
suspect,1,2,0,2,5
tamiflu,5,0,0,0,5
technical,1,1,1,2,5
technically,0,4,1,0,5
teenager,3,0,2,0,5
threat,2,0,1,2,5
tight,1,1,2,1,5
till,1,1,2,1,5
toddler,0,2,2,1,5
touch,2,1,1,1,5
translate,1,1,3,0,5
transparency,2,1,0,2,5
trick,1,0,2,2,5
trust,3,1,1,0,5
truth,1,2,2,0,5
typical,0,0,4,1,5
uni,0,3,2,0,5
unique,1,1,2,1,5
vacuum,0,0,2,3,5
valid,0,0,5,0,5
valley,1,1,2,1,5
vaud,0,0,5,0,5
venue,0,4,0,1,5
vet,1,2,0,2,5
violation,3,0,0,2,5
walkable,3,1,1,0,5
walking,2,2,0,1,5
watson,0,5,0,0,5
weak,1,2,1,1,5
weed,0,3,2,0,5
wood,0,0,3,2,5
worried,2,0,0,3,5
zoo,0,3,2,0,5
abuse,2,2,0,0,4
accountant,1,3,0,0,4
aclu,4,0,0,0,4
acton,2,2,0,0,4
adapt,0,1,3,0,4
adjacent,2,1,0,1,4
administrative,3,0,1,0,4
advertise,0,1,2,1,4
afin,0,0,4,0,4
ainslie,0,4,0,0,4
alewife,4,0,0,0,4
align,2,0,2,0,4
allocate,1,0,3,0,4
allowance,0,0,4,0,4
anglais,0,0,2,2,4
annemasse,0,0,4,0,4
annual,1,1,2,0,4
anthem,0,0,0,4,4
appliance,0,1,1,2,4
approval,0,4,0,0,4
approximately,2,0,0,2,4
appts,0,1,0,3,4
arboretum,2,2,0,0,4
arena,1,0,1,2,4
arlington,4,0,0,0,4
arm,4,0,0,0,4
artefact,0,4,0,0,4
asap,1,0,2,1,4
aside,2,1,0,1,4
av,0,1,3,0,4
avant,0,0,4,0,4
avenue,0,0,3,1,4
awhile,1,1,0,2,4
barrier,1,0,1,2,4
batch,2,2,0,0,4
bath,0,0,1,3,4
battle,3,0,0,1,4
bbq,2,2,0,0,4
bc,2,0,0,2,4
beat,0,1,3,0,4
beef,0,2,0,2,4
billion,1,2,1,0,4
bishop,0,4,0,0,4
blind,1,3,0,0,4
boat,2,2,0,0,4
bon,0,0,4,0,4
bone,1,2,0,1,4
bonne,0,0,2,2,4
boutique,0,1,2,1,4
boycott,4,0,0,0,4
boylston,4,0,0,0,4
bpl,4,0,0,0,4
breakfast,2,2,0,0,4
bright,2,0,0,2,4
btiments,0,0,4,0,4
bubble,0,0,3,1,4
buck,1,0,0,3,4
bulb,0,0,3,1,4
bun,0,3,0,1,4
bureau,0,0,4,0,4
bush,0,1,3,0,4
buying,0,2,0,2,4
cage,0,1,0,3,4
calculate,0,0,4,0,4
calm,0,1,2,1,4
camp,3,0,0,1,4
campaign,3,1,0,0,4
campbell,2,2,0,0,4
camping,0,1,2,1,4
candidate,1,0,2,1,4
canturf,0,4,0,0,4
castle,2,0,2,0,4
cathedral,0,0,4,0,4
cd,0,0,4,0,4
cent,0,1,0,3,4
cern,0,0,4,0,4
challenge,2,1,0,1,4
chancellor,0,4,0,0,4
channel,1,0,1,2,4
chaque,0,0,4,0,4
cher,0,0,4,0,4
chest,0,1,0,3,4
chill,1,2,0,1,4
circle,3,0,1,0,4
cleaning,0,0,0,4,4
click,1,0,2,1,4
client,0,1,3,0,4
closure,0,3,1,0,4
clothing,1,1,0,2,4
coalition,3,1,0,0,4
cocktail,1,3,0,0,4
collect,3,1,0,0,4
collection,2,2,0,0,4
combine,1,2,0,1,4
comm,3,1,0,0,4
communication,2,0,0,2,4
comparable,1,2,1,0,4
concept,2,1,0,1,4
concerned,3,1,0,0,4
conduct,4,0,0,0,4
conflict,2,1,0,1,4
confuse,2,0,1,1,4
congest,0,1,3,0,4
constitution,3,1,0,0,4
consultancy,0,1,3,0,4
consultant,1,0,2,1,4
consume,2,0,1,1,4
content,0,3,1,0,4
contre,0,0,4,0,4
countryside,0,0,4,0,4
coverage,0,0,2,2,4
crace,0,4,0,0,4
crime,3,0,0,1,4
custom,2,1,0,1,4
dad,3,1,0,0,4
defend,2,1,1,0,4
democratic,3,0,1,0,4
deny,3,0,1,0,4
depart,2,0,2,0,4
deportation,4,0,0,0,4
depuis,0,0,4,0,4
deserve,1,2,0,1,4
dessert,0,2,0,2,4
detailed,0,1,2,1,4
device,0,1,1,2,4
dig,0,0,4,0,4
din,1,3,0,0,4
dirt,1,0,1,2,4
disappear,2,0,1,1,4
discrimination,1,2,0,1,4
district,2,1,0,1,4
dj,0,0,4,0,4
doc,0,3,0,1,4
donc,0,0,4,0,4
dorchester,4,0,0,0,4
douane,0,0,4,0,4
downside,0,2,0,2,4
driveway,2,0,0,2,4
drone,1,3,0,0,4
dude,3,1,0,0,4
dumpling,0,2,0,2,4
ear,1,0,0,3,4
earlier,0,3,0,1,4
eaux,0,0,4,0,4
elect,2,0,0,2,4
embassy,0,1,1,2,4
environ,0,0,4,0,4
epic,1,3,0,0,4
esplanade,4,0,0,0,4
ex,0,1,2,1,4
exhibition,2,2,0,0,4
expertise,1,1,0,2,4
extreme,1,2,1,0,4
fabric,0,1,0,3,4
factory,1,0,1,2,4
fais,0,0,4,0,4
faith,3,1,0,0,4
faneuil,4,0,0,0,4
faon,0,0,1,3,4
fen,4,0,0,0,4
fence,1,0,0,3,4
finger,1,2,1,0,4
flood,1,3,0,0,4
following,0,1,3,0,4
footpath,0,2,2,0,4
forever,0,2,1,1,4
franais,0,0,2,2,4
fraud,0,1,0,3,4
frontire,0,0,1,3,4
frustrating,1,2,1,0,4
fry,0,2,2,0,4
fyi,1,0,2,1,4
gap,0,4,0,0,4
gatineau,0,0,0,4,4
gay,0,0,0,4,4
gem,0,2,0,2,4
genevieve,0,4,0,0,4
genevois,0,0,4,0,4
german,0,1,3,0,4
golden,1,0,1,2,4
gorgeous,0,2,1,1,4
gps,1,3,0,0,4
grad,4,0,0,0,4
graffiti,0,2,2,0,4
grateful,2,1,0,1,4
gva,0,0,4,0,4
gym,0,3,0,1,4
hardware,0,3,1,0,4
hayden,1,3,0,0,4
healthcare,2,1,0,1,4
healthy,2,0,1,1,4
heap,0,4,0,0,4
heart,3,0,0,1,4
hobby,1,2,0,1,4
hood,0,1,1,2,4
horse,1,2,1,0,4
household,2,2,0,0,4
hr,1,2,0,1,4
hub,1,0,0,3,4
hudson,4,0,0,0,4
humane,0,0,0,4,4
hype,1,3,0,0,4
ici,0,0,3,1,4
identity,2,0,1,1,4
ideology,3,0,0,1,4
iirc,0,1,1,2,4
illegals,4,0,0,0,4
immediate,1,0,0,3,4
immersion,0,0,1,3,4
implement,1,0,0,3,4
improvement,2,1,1,0,4
incident,2,1,1,0,4
ingredient,1,1,2,0,4
insanely,1,3,0,0,4
install,0,0,3,1,4
installation,1,1,0,2,4
intention,3,0,0,1,4
invite,2,1,1,0,4
italy,0,0,3,1,4
itch,2,1,0,1,4
james,1,1,0,2,4
jardin,0,0,3,1,4
jet,1,0,2,1,4
jfk,4,0,0,0,4
junction,0,1,3,0,4
june,1,1,0,2,4
kenmore,4,0,0,0,4
knock,0,3,1,0,4
knowledgeable,0,0,1,3,4
labor,0,1,2,1,4
layer,2,0,2,0,4
lazy,0,2,2,0,4
leader,2,2,0,0,4
leak,0,3,0,1,4
lemon,2,1,0,1,4
leverage,1,0,3,0,4
lie,1,2,0,1,4
limited,2,1,0,1,4
loan,1,1,0,2,4
lobby,0,1,2,1,4
logement,0,0,4,0,4
logements,0,0,4,0,4
lors,0,0,4,0,4
lyon,0,1,1,2,4
madness,2,1,1,0,4
maga,2,1,0,1,4
magnet,2,1,0,1,4
maker,2,1,0,1,4
male,1,0,1,2,4
manchester,4,0,0,0,4
material,2,0,0,2,4
maternelle,0,0,0,4,4
median,0,1,1,2,4
medication,0,0,1,3,4
mediocre,1,1,2,0,4
meetup,0,1,2,1,4
meh,0,1,2,1,4
mentality,1,1,2,0,4
merge,1,0,3,0,4
method,1,3,0,0,4
meyrin,0,0,4,0,4
migrant,1,0,2,1,4
migration,3,0,1,0,4
minimize,1,0,2,1,4
mixed,0,2,2,0,4
mobile,0,1,3,0,4
mode,2,1,1,0,4
module,0,0,0,4,4
mois,0,0,4,0,4
mon,0,0,4,0,4
monde,0,0,4,0,4
montant,0,0,4,0,4
monthly,0,1,3,0,4
mormon,0,0,4,0,4
motorcycle,0,1,3,0,4
necessarily,1,1,2,0,4
nest,1,2,1,0,4
nick,0,3,0,1,4
nightmare,0,2,2,0,4
nimby,2,2,0,0,4
noon,2,0,0,2,4
nyc,4,0,0,0,4
obtain,0,3,1,0,4
oc,0,0,0,4,4
occasional,2,2,0,0,4
ongoing,1,1,0,2,4
organize,0,0,3,1,4
orgs,4,0,0,0,4
originally,1,2,0,1,4
otto,0,0,0,4,4
outright,1,0,0,3,4
overhead,3,1,0,0,4
pace,1,0,1,2,4
pad,0,1,1,2,4
paperwork,0,0,3,1,4
passport,2,0,2,0,4
pc,0,1,1,2,4
pendant,1,0,3,0,4
perception,0,0,4,0,4
performance,1,2,0,1,4
personnel,3,0,0,1,4
physical,2,2,0,0,4
physically,0,2,1,1,4
planning,2,2,0,0,4
pleasant,2,2,0,0,4
plug,3,0,1,0,4
porter,4,0,0,0,4
pquis,0,0,4,0,4
predict,1,1,0,2,4
prefer,0,2,2,0,4
prescribe,2,1,0,1,4
print,1,0,1,2,4
provider,1,0,3,0,4
publish,2,1,0,1,4
pursue,1,2,1,0,4
qualify,2,1,1,0,4
quincy,4,0,0,0,4
ramp,3,1,0,0,4
raw,1,1,0,2,4
reaction,2,1,0,1,4
reader,1,0,2,1,4
realize,1,0,2,1,4
recognize,0,1,1,2,4
refugee,2,0,0,2,4
registered,0,0,4,0,4
relation,0,1,2,1,4
renovation,0,1,2,1,4
reputation,0,2,2,0,4
rescue,0,0,0,4,4
reserve,2,2,0,0,4
residential,2,2,0,0,4
restriction,0,3,1,0,4
root,1,2,0,1,4
rough,1,1,0,2,4
saconnex,0,0,4,0,4
sacrifice,0,1,2,1,4
sans,0,0,4,0,4
sbb,0,0,4,0,4
scam,0,0,4,0,4
scammed,0,0,4,0,4
scheme,0,3,0,1,4
schooling,0,1,1,2,4
scoop,0,1,0,3,4
seating,0,1,1,2,4
seemingly,1,0,1,2,4
serait,0,0,4,0,4
seront,0,0,4,0,4
seul,0,0,3,1,4
severe,1,2,0,1,4
shut,2,2,0,0,4
sky,1,1,0,2,4
slide,1,0,0,3,4
slip,0,3,1,0,4
smart,0,1,0,3,4
smash,3,1,0,0,4
snap,2,0,0,2,4
song,0,3,0,1,4
soup,0,1,0,3,4
spark,0,1,0,3,4
spectacular,2,1,1,0,4
steel,0,0,1,3,4
stone,1,0,1,2,4
strawberry,0,2,0,2,4
stretch,0,0,4,0,4
string,1,1,2,0,4
subscription,0,1,0,3,4
suit,0,1,2,1,4
superior,2,0,2,0,4
supermarket,0,3,1,0,4
supplier,0,1,0,3,4
supreme,3,0,1,0,4
surface,0,3,1,0,4
surgery,0,4,0,0,4
surroundings,0,0,4,0,4
swim,1,3,0,0,4
tank,1,0,0,3,4
tbh,1,2,1,0,4
td,4,0,0,0,4
temporary,2,1,1,0,4
therapist,0,0,0,4,4
throat,1,0,0,3,4
tick,0,3,1,0,4
timing,2,1,0,1,4
tomorrow,1,2,0,1,4
toute,0,0,4,0,4
transgender,1,3,0,0,4
transpo,0,0,0,4,4
truly,3,0,1,0,4
tub,4,0,0,0,4
turning,1,0,2,1,4
twin,2,0,1,1,4
twitter,3,0,0,1,4
unsure,1,2,1,0,4
update,2,0,1,1,4
upload,0,1,1,2,4
upstairs,0,1,2,1,4
ur,0,1,3,0,4
used,0,0,3,1,4
va,0,0,4,0,4
vat,0,0,4,0,4
vice,1,2,1,0,4
vives,0,0,4,0,4
voice,1,0,1,2,4
volume,0,2,0,2,4
vs,0,1,0,3,4
waiter,0,0,2,2,4
wash,2,0,1,1,4
washington,3,0,0,1,4
wasp,0,2,2,0,4
wealthy,1,2,1,0,4
wedding,1,2,0,1,4
wiring,2,2,0,0,4
wool,0,0,0,4,4
worse,2,0,0,2,4
wrap,1,2,0,1,4
yearly,0,1,1,2,4
zone,3,0,1,0,4
zurich,0,0,4,0,4
abandon,1,1,0,1,3
abroad,1,0,2,0,3
absence,0,2,1,0,3
ac,0,2,0,1,3
accident,0,1,0,2,3
accompany,1,2,0,0,3
accurate,0,0,2,1,3
addons,0,1,0,2,3
advocate,2,0,0,1,3
african,0,0,2,1,3
ag,2,0,1,0,3
aim,0,0,3,0,3
ainsi,0,0,3,0,3
ait,0,0,3,0,3
akiba,0,3,0,0,3
aldi,0,1,2,0,3
algonquin,0,0,0,3,3
alive,0,0,1,2,3
alleviate,0,1,2,0,3
alot,0,1,2,0,3
amazon,1,0,1,1,3
anger,3,0,0,0,3
annecy,0,0,3,0,3
annoying,0,2,0,1,3
anxiety,0,3,0,0,3
apologize,0,0,0,3,3
appartement,0,0,3,0,3
appeal,1,0,0,2,3
appetizer,0,0,2,1,3
approx,0,2,0,1,3
argument,0,0,1,2,3
armures,0,0,3,0,3
arrange,0,1,2,0,3
arrangement,0,2,0,1,3
arrival,0,0,2,1,3
artificial,0,1,1,1,3
artificially,0,0,3,0,3
assign,0,1,1,1,3
assistance,1,2,0,0,3
associate,1,0,1,1,3
assure,1,2,0,0,3
aucune,0,0,2,1,3
autumn,0,2,1,0,3
avez,0,0,2,1,3
badly,0,1,2,0,3
balcony,0,1,1,1,3
balloon,0,2,0,1,3
ban,2,0,0,1,3
bang,0,0,0,3,3
barber,0,2,0,1,3
bargain,0,1,1,1,3
barton,0,3,0,0,3
bathroom,1,0,1,1,3
battery,2,0,0,1,3
bcge,0,0,3,0,3
belief,2,0,0,1,3
beneficial,1,0,0,2,3
berlin,0,1,2,0,3
bf,0,0,0,3,3
biden,3,0,0,0,3
billing,0,1,0,2,3
blanc,0,0,3,0,3
blast,1,0,1,1,3
blood,1,2,0,0,3
bonjour,0,0,2,1,3
bonus,0,1,1,1,3
botanic,0,3,0,0,3
bowling,3,0,0,0,3
brave,0,2,0,1,3
brick,1,2,0,0,3
bro,1,2,0,0,3
brockton,3,0,0,0,3
broke,0,2,0,1,3
buffalo,0,2,0,1,3
builder,0,1,0,2,3
burden,1,1,1,0,3
bypass,0,3,0,0,3
carbon,2,0,0,1,3
careful,0,1,2,0,3
carefully,1,1,0,1,3
cater,2,0,1,0,3
celebrate,0,1,1,1,3
cell,1,0,1,1,3
certaines,0,0,3,0,3
cervidil,0,0,0,3,3
cff,0,0,3,0,3
challenging,2,0,1,0,3
chantepoulet,0,0,3,0,3
chaos,0,0,2,1,3
chaotic,1,1,0,1,3
character,0,2,0,1,3
chateau,0,0,1,2,3
chatgpt,0,1,2,0,3
cheer,0,1,2,0,3
childcare,1,1,1,0,3
chunk,0,1,0,2,3
classroom,0,0,0,3,3
clay,1,2,0,0,3
cleaner,1,0,1,1,3
clearing,0,0,1,2,3
climb,0,2,1,0,3
clog,0,1,1,1,3
closing,0,0,1,2,3
code,1,0,2,0,3
collective,1,0,1,1,3
colonel,0,0,0,3,3
combination,0,0,1,2,3
commerce,0,0,3,0,3
commie,0,0,3,0,3
commitment,2,0,1,0,3
commonwealth,2,1,0,0,3
commun,0,0,2,1,3
communicate,1,0,2,0,3
commuting,0,0,2,1,3
compassionate,0,0,0,3,3
competent,0,0,0,3,3
compris,0,0,3,0,3
condensation,0,1,2,0,3
confident,0,1,1,1,3
congratulation,1,0,2,0,3
connor,0,1,0,2,3
conomique,0,0,3,0,3
conservation,3,0,0,0,3
contractor,0,2,0,1,3
contrat,0,0,3,0,3
contribute,1,1,1,0,3
convention,3,0,0,0,3
conviction,2,1,0,0,3
core,0,1,0,2,3
councilor,0,0,2,1,3
county,3,0,0,0,3
craft,2,0,0,1,3
crash,2,1,0,0,3
curse,1,1,1,0,3
dairy,0,1,0,2,3
danger,0,0,0,3,3
dangerously,0,2,0,1,3
danvers,3,0,0,0,3
daughter,1,0,0,2,3
dcembre,0,0,3,0,3
debacle,0,3,0,0,3
decrease,1,0,1,1,3
deficit,0,2,0,1,3
dell,2,0,1,0,3
demographic,1,1,1,0,3
density,0,3,0,0,3
departure,0,1,2,0,3
depends,1,0,1,1,3
desire,0,1,1,1,3
destination,0,1,1,1,3
detain,3,0,0,0,3
devant,0,0,3,0,3
di,0,0,3,0,3
dickhead,0,3,0,0,3
digital,0,1,1,1,3
dip,0,1,2,0,3
diploma,0,0,0,3,3
diplomat,1,0,2,0,3
dirty,0,1,0,2,3
discussion,0,2,1,0,3
disgust,1,1,1,0,3
disrupt,2,0,1,0,3
distress,1,0,0,2,3
distribute,1,0,1,1,3
dit,0,0,3,0,3
dive,1,1,1,0,3
diverse,2,1,0,0,3
divorce,0,2,1,0,3
doge,2,1,0,0,3
dose,1,0,0,2,3
downvote,1,1,0,1,3
dpend,0,0,3,0,3
dream,0,2,1,0,3
drinking,0,1,0,2,3
droit,0,0,3,0,3
duck,2,1,0,0,3
dumb,3,0,0,0,3
dump,0,0,0,3,3
duty,2,0,0,1,3
dynamic,1,0,2,0,3
easyride,0,0,3,0,3
eater,0,1,2,0,3
ecolint,0,0,3,0,3
educator,1,1,0,1,3
effectively,2,1,0,0,3
eh,0,0,1,2,3
elaine,0,3,0,0,3
elderly,0,2,0,1,3
electronics,0,0,3,0,3
elementary,1,0,0,2,3
emo,0,2,0,1,3
emotional,0,1,1,1,3
enable,2,0,1,0,3
enbridge,0,0,0,3,3
encore,0,0,3,0,3
engage,1,1,1,0,3
entitlement,1,1,1,0,3
entrance,1,0,0,2,3
environmental,3,0,0,0,3
epfl,0,0,3,0,3
episode,1,0,0,2,3
era,0,0,2,1,3
error,2,0,1,0,3
espresso,0,3,0,0,3
establish,2,1,0,0,3
eta,2,0,0,1,3
eventually,0,3,0,0,3
evolve,2,0,0,1,3
exceed,1,0,1,1,3
exception,1,0,2,0,3
exciting,1,1,0,1,3
exclude,1,1,0,1,3
executive,1,1,0,1,3
exempt,1,0,2,0,3
exhaust,1,0,1,1,3
expectation,1,1,0,1,3
expire,0,2,1,0,3
explanation,0,3,0,0,3
extended,1,1,0,1,3
faades,0,0,3,0,3
fabrication,0,0,0,3,3
failing,0,0,1,2,3
faison,3,0,0,0,3
faut,0,0,3,0,3
fb,1,2,0,0,3
feasible,1,1,0,1,3
feature,0,0,1,2,3
fed,1,1,0,1,3
femme,0,0,1,2,3
fencing,0,2,0,1,3
festival,0,1,0,2,3
fiber,1,0,1,1,3
filling,0,3,0,0,3
fin,0,1,2,0,3
flash,0,3,0,0,3
fluffy,1,0,2,0,3
fork,0,1,2,0,3
foule,0,0,3,0,3
fountain,1,1,1,0,3
frame,1,1,0,1,3
fried,1,1,0,1,3
frustrate,1,0,0,2,3
frustrated,0,0,1,2,3
ft,1,0,0,2,3
fusion,0,3,0,0,3
fwiw,1,0,0,2,3
gaming,1,1,0,1,3
garbage,0,0,0,3,3
gardner,3,0,0,0,3
gastric,1,2,0,0,3
generate,0,0,1,2,3
genevan,0,0,3,0,3
genre,0,0,3,0,3
gex,0,0,3,0,3
gift,0,0,3,0,3
global,0,1,2,0,3
gnrale,0,0,1,2,3
goal,1,0,2,0,3
gp,0,2,0,1,3
grande,0,0,3,0,3
grill,0,2,1,0,3
guest,0,1,2,0,3
guilty,2,1,0,0,3
habit,0,1,1,1,3
hairdresser,0,3,0,0,3
halifax,0,0,0,3,3
harass,1,1,0,1,3
heal,0,1,1,1,3
heard,0,1,0,2,3
heck,2,0,1,0,3
hello,0,0,2,1,3
hemisphere,0,3,0,0,3
hilarious,0,2,0,1,3
hindmarsh,0,3,0,0,3
hong,3,0,0,0,3
hospitality,1,1,0,1,3
icon,0,1,2,0,3
idp,0,3,0,0,3
import,0,1,0,2,3
inclusive,0,1,0,2,3
increasingly,1,1,1,0,3
indigenous,0,2,0,1,3
indonesian,0,3,0,0,3
inefficient,1,1,1,0,3
inevitable,1,2,0,0,3
infant,0,0,2,1,3
influence,0,0,3,0,3
inform,0,1,1,1,3
initially,1,1,1,0,3
initiative,1,1,0,1,3
injury,1,2,0,0,3
inquiry,0,2,0,1,3
inspect,1,1,0,1,3
inspection,1,2,0,0,3
instructor,0,0,1,2,3
interaction,2,0,1,0,3
invasive,2,1,0,0,3
jamison,0,3,0,0,3
jan,1,2,0,0,3
jean,0,0,1,2,3
jewish,3,0,0,0,3
judgement,1,1,0,1,3
jurisdiction,1,1,0,1,3
justification,0,0,3,0,3
kambah,0,3,0,0,3
kendall,3,0,0,0,3
kippax,0,3,0,0,3
kong,3,0,0,0,3
koto,0,3,0,0,3
lancy,0,0,3,0,3
lastly,2,0,0,1,3
lecture,1,1,1,0,3
leg,2,0,0,1,3
legally,2,0,0,1,3
legit,1,0,2,0,3
leman,0,0,3,0,3
lens,0,0,0,3,3
lesbian,0,0,0,3,3
lift,1,2,0,0,3
likewise,1,1,1,0,3
logan,3,0,0,0,3
lookout,0,0,0,3,3
lover,1,1,1,0,3
lower,2,0,0,1,3
lunchtime,0,1,2,0,3
mafia,0,2,0,1,3
mailing,0,2,0,1,3
makeup,0,3,0,0,3
mal,0,0,3,0,3
mandatory,0,0,2,1,3
manner,0,0,2,1,3
mariage,0,0,3,0,3
marketing,1,2,0,0,3
massively,1,1,0,1,3
match,1,2,0,0,3
mate,0,3,0,0,3
mawson,0,3,0,0,3
max,0,1,1,1,3
meadow,3,0,0,0,3
mechanic,0,3,0,0,3
melrose,3,0,0,0,3
melt,1,0,0,2,3
meme,0,0,2,1,3
mentor,0,0,0,3,3
merivale,0,0,0,3,3
messy,1,1,1,0,3
mesure,0,0,3,0,3
mettre,0,0,3,0,3
mgb,3,0,0,0,3
mild,0,2,0,1,3
milieu,0,0,3,0,3
military,0,1,1,1,3
mini,1,0,2,0,3
minimal,1,1,0,1,3
minor,1,1,1,0,3
missionary,0,0,3,0,3
moi,0,0,3,0,3
monitor,1,0,1,1,3
motivation,0,1,2,0,3
mouth,1,0,1,1,3
movement,1,1,0,1,3
mow,0,3,0,0,3
multi,2,0,1,0,3
multicultural,0,1,2,0,3
mum,0,2,1,0,3
municipal,1,0,0,2,3
murder,2,0,1,0,3
murray,0,3,0,0,3
musk,3,0,0,0,3
nasty,1,1,0,1,3
navigate,1,2,0,0,3
neck,2,0,1,0,3
netflix,2,0,0,1,3
nhl,0,1,0,2,3
nicer,1,0,1,1,3
nightclub,0,1,2,0,3
nombre,0,0,3,0,3
normalement,0,0,3,0,3
northern,0,3,0,0,3
northside,0,2,0,1,3
november,1,1,0,1,3
nyon,0,0,3,0,3
obligation,0,0,3,0,3
observation,0,0,3,0,3
officially,0,1,1,1,3
onsite,0,2,1,0,3
onzieme,0,3,0,0,3
oppose,1,1,1,0,3
organic,0,1,0,2,3
organise,0,1,2,0,3
outpatient,1,0,0,2,3
outta,0,3,0,0,3
overly,0,0,0,3,3
overnight,1,1,0,1,3
overpass,1,0,1,1,3
overwhelm,1,1,0,1,3
pacific,0,3,0,0,3
paint,2,0,1,0,3
pandemic,2,1,0,0,3
parc,0,1,2,0,3
pardon,2,0,1,0,3
parliament,0,3,0,0,3
participant,3,0,0,0,3
partie,0,0,3,0,3
passenger,1,0,1,1,3
pasta,0,1,1,1,3
pastry,2,1,0,0,3
pause,1,1,0,1,3
pavement,2,0,1,0,3
payroll,1,2,0,0,3
peace,1,0,2,0,3
percent,3,0,0,0,3
perspective,0,1,2,0,3
petite,0,0,2,1,3
peu,0,0,3,0,3
pharmacy,0,0,2,1,3
phenomenon,0,0,3,0,3
phillip,0,3,0,0,3
pile,2,0,0,1,3
pint,1,1,0,1,3
piss,2,1,0,0,3
plat,0,0,2,1,3
player,1,0,0,2,3
playground,0,2,1,0,3
plaza,0,1,0,2,3
plot,1,0,0,2,3
politely,0,1,2,0,3
popcorn,2,0,0,1,3
popular,0,2,0,1,3
possibility,0,1,1,1,3
pot,0,2,1,0,3
pregnancy,0,1,0,2,3
pregnant,1,1,0,1,3
prep,1,1,0,1,3
presence,1,1,0,1,3
presentation,1,0,2,0,3
preserve,1,1,1,0,3
prevent,0,1,0,2,3
previously,0,2,1,0,3
pricey,0,2,1,0,3
pride,1,0,0,2,3
primarily,0,2,0,1,3
printed,0,1,1,1,3
privacy,0,1,2,0,3
procedure,1,1,1,0,3
propaganda,1,1,0,1,3
providence,1,0,0,2,3
provincial,0,0,0,3,3
pure,1,1,1,0,3
qu,0,0,3,0,3
quai,0,0,3,0,3
quantity,0,0,3,0,3
queen,1,0,0,2,3
race,2,0,0,1,3
rainy,0,2,1,0,3
ranking,0,1,0,2,3
rapid,0,3,0,0,3
react,0,0,2,1,3
realise,0,1,1,1,3
realistically,2,0,0,1,3
rebel,1,2,0,0,3
rebuild,1,1,1,0,3
recherche,0,0,3,0,3
recipe,1,0,1,1,3
recognise,0,3,0,0,3
recognition,2,0,1,0,3
recruit,1,0,2,0,3
reduction,0,1,2,0,3
referral,0,1,0,2,3
regarde,0,0,3,0,3
regret,1,1,0,1,3
regulation,2,0,0,1,3
release,1,1,0,1,3
relief,0,1,1,1,3
religion,1,0,2,0,3
relocation,0,0,3,0,3
renewal,1,0,1,1,3
repaint,0,3,0,0,3
representative,3,0,0,0,3
republic,2,0,1,0,3
residence,0,1,1,1,3
residency,3,0,0,0,3
resort,1,0,2,0,3
respectful,0,0,3,0,3
responsibility,1,1,1,0,3
reste,0,0,3,0,3
restos,0,0,0,3,3
revenue,0,3,0,0,3
risque,0,0,3,0,3
rive,0,0,3,0,3
roadworks,0,3,0,0,3
rochester,0,0,0,3,3
romantic,0,2,1,0,3
rooftop,0,2,0,1,3
rout,1,0,2,0,3
rseau,0,0,1,2,3
rubbish,0,3,0,0,3
rude,1,0,1,1,3
ruin,1,1,0,1,3
rural,1,1,0,1,3
safer,2,0,1,0,3
saint,0,0,3,0,3
salesman,0,0,1,2,3
sam,1,1,1,0,3
sanction,0,0,3,0,3
sandwich,2,1,0,0,3
sauna,0,1,2,0,3
saver,3,0,0,0,3
scammer,0,0,3,0,3
scar,0,0,2,1,3
scary,2,0,0,1,3
screenshot,3,0,0,0,3
seasonal,2,0,0,1,3
segment,0,1,0,2,3
seller,0,1,1,1,3
sensitive,1,0,0,2,3
sentence,1,0,2,0,3
seperate,1,1,1,0,3
series,2,1,0,0,3
servant,2,1,0,0,3
setup,1,1,0,1,3
sex,1,0,0,2,3
shell,1,2,0,0,3
shiny,1,2,0,0,3
shipping,0,0,3,0,3
shirt,1,0,1,1,3
shitty,1,2,0,0,3
showing,3,0,0,0,3
sismondi,0,0,3,0,3
skin,0,1,2,0,3
skip,0,0,3,0,3
sled,0,0,2,1,3
sleeve,1,0,0,2,3
slice,2,1,0,0,3
smack,1,2,0,0,3
socially,1,1,0,1,3
sock,3,0,0,0,3
somebody,1,2,0,0,3
someday,1,0,0,2,3
somerset,1,0,0,2,3
somerville,3,0,0,0,3
somewhat,0,2,0,1,3
sore,1,0,0,2,3
southie,3,0,0,0,3
southside,0,3,0,0,3
specialization,0,0,2,1,3
specialty,1,0,2,0,3
spending,0,2,0,1,3
stable,0,1,1,1,3
staffer,1,0,2,0,3
stall,0,2,0,1,3
stereotype,1,1,1,0,3
sterilisation,0,3,0,0,3
sticky,1,2,0,0,3
stir,1,1,1,0,3
storage,0,0,2,1,3
storefront,0,0,3,0,3
strain,1,1,1,0,3
stranger,0,1,1,1,3
stressful,0,0,2,1,3
strict,0,0,3,0,3
stroll,0,1,2,0,3
strongly,1,1,1,0,3
su,0,2,1,0,3
suburban,0,1,0,2,3
sugar,1,0,0,2,3
suivant,0,0,3,0,3
summary,1,0,1,1,3
sunset,0,2,0,1,3
surgeon,0,3,0,0,3
surprising,0,2,0,1,3
surrender,0,1,0,2,3
survey,1,0,1,1,3
survival,0,1,0,2,3
suspicious,1,0,2,0,3
sustainable,1,2,0,0,3
swap,1,0,0,2,3
swear,0,0,3,0,3
sweat,0,0,0,3,3
sweater,2,0,0,1,3
tailor,0,0,1,2,3
takeaway,0,0,3,0,3
tale,0,1,0,2,3
tant,0,0,3,0,3
tasty,2,0,1,0,3
technique,1,2,0,0,3
territory,0,2,0,1,3
texture,3,0,0,0,3
thats,1,1,1,0,3
theme,2,0,0,1,3
theo,0,3,0,0,3
therapy,0,0,0,3,3
thermal,2,0,0,1,3
thrift,2,0,0,1,3
tie,1,0,1,1,3
tiktok,1,2,0,0,3
tonne,0,3,0,0,3
toyota,0,0,0,3,3
training,0,1,1,1,3
transition,0,1,1,1,3
translation,0,2,1,0,3
tristan,0,1,0,2,3
trivial,1,0,1,1,3
trop,0,0,3,0,3
truffle,0,2,1,0,3
tugger,0,3,0,0,3
turf,0,0,0,3,3
typically,0,0,1,2,3
ultimately,1,0,2,0,3
uncertainty,1,0,0,2,3
uncle,2,0,1,0,3
uncomfortable,1,1,0,1,3
undergo,1,2,0,0,3
understandable,3,0,0,0,3
unfortunate,0,0,1,2,3
unige,0,0,3,0,3
uniquely,1,1,1,0,3
unknown,0,0,3,0,3
unnecessary,0,0,2,1,3
unusual,0,0,2,1,3
upper,2,0,0,1,3
utile,0,0,3,0,3
vaccine,0,2,0,1,3
vague,1,1,0,1,3
valentine,1,0,0,2,3
valuable,0,0,2,1,3
vanier,0,0,0,3,3
variety,0,1,1,1,3
vary,1,0,1,1,3
vegetable,0,0,2,1,3
vendor,0,0,0,3,3
vers,0,0,3,0,3
versoix,0,0,3,0,3
vibe,1,1,0,1,3
vintage,0,0,0,3,3
violent,3,0,0,0,3
virginia,3,0,0,0,3
vocal,2,0,0,1,3
voir,0,0,3,0,3
vraiment,0,0,2,1,3
waitlists,1,2,0,0,3
warren,3,0,0,0,3
wart,0,3,0,0,3
weapon,1,0,2,0,3
wednesday,1,0,0,2,3
weekly,0,0,1,2,3
wet,0,2,0,1,3
whatsapp,0,0,3,0,3
windy,2,0,1,0,3
winner,1,1,1,0,3
wipe,1,0,1,1,3
witness,2,1,0,0,3
wolf,0,0,0,3,3
wow,3,0,0,0,3
wtf,2,0,1,0,3
absurdly,1,0,0,1,2
academy,1,0,1,0,2
accommodate,0,2,0,0,2
accurately,0,0,1,1,2
acknowledge,1,1,0,0,2
acoustic,0,0,2,0,2
acre,0,0,0,2,2
activate,0,1,1,0,2
activist,1,0,0,1,2
adaptive,1,0,0,1,2
added,1,0,1,0,2
addict,0,0,0,2,2
administer,0,1,0,1,2
adventure,1,0,1,0,2
advertising,0,1,1,0,2
advocacy,1,0,0,1,2
agenda,1,1,0,0,2
ah,0,2,0,0,2
aka,0,0,1,1,2
albeit,1,0,0,1,2
alert,0,1,1,0,2
alertswiss,0,0,2,0,2
alley,0,1,0,1,2
ally,1,0,0,1,2
amenity,1,1,0,0,2
ample,0,2,0,0,2
ancient,1,1,0,0,2
anecdotally,0,0,1,1,2
angle,2,0,0,0,2
anibis,0,0,2,0,2
animation,0,0,0,2,2
annoyed,0,0,0,2,2
anti,0,1,1,0,2
anybody,1,0,1,0,2
approved,0,2,0,0,2
apt,1,0,0,1,2
arcade,2,0,0,0,2
archaeological,0,2,0,0,2
army,1,0,0,1,2
artery,0,1,1,0,2
artisan,1,0,1,0,2
asia,0,1,0,1,2
ass,1,0,1,0,2
assessment,0,2,0,0,2
assez,0,0,2,0,2
aucun,0,0,2,0,2
audience,0,1,1,0,2
aunt,1,0,0,1,2
automate,0,1,1,0,2
autour,0,0,2,0,2
autre,0,0,2,0,2
avalanche,0,0,1,1,2
avis,0,0,2,0,2
award,2,0,0,0,2
axe,1,0,1,0,2
bachelor,0,0,0,2,2
backwards,1,0,1,0,2
balance,1,0,0,1,2
band,2,0,0,0,2
banker,1,0,1,0,2
bardonnex,0,0,2,0,2
bare,0,2,0,0,2
bark,0,1,0,1,2
barn,1,0,0,1,2
barrhaven,0,0,0,2,2
basel,0,0,2,0,2
basement,1,0,0,1,2
basis,1,0,1,0,2
bathurst,0,2,0,0,2
bean,2,0,0,0,2
bearing,1,0,1,0,2
beg,1,0,0,1,2
beginning,0,0,2,0,2
belong,1,1,0,0,2
berate,1,0,0,1,2
bernex,0,0,2,0,2
besoin,0,0,2,0,2
beverly,2,0,0,0,2
bid,2,0,0,0,2
bigfoot,1,0,0,1,2
biking,1,0,1,0,2
bind,0,0,0,2,2
birth,1,0,0,1,2
bitch,0,0,0,2,2
bite,0,0,0,2,2
blare,1,0,0,1,2
blatant,2,0,0,0,2
blink,1,0,0,1,2
bloke,0,1,1,0,2
bloquent,0,0,2,0,2
blur,0,1,1,0,2
boarder,0,0,1,1,2
boarding,0,0,2,0,2
bob,1,0,0,1,2
boil,0,1,0,1,2
bois,0,0,2,0,2
bookshop,0,2,0,0,2
boomer,1,0,1,0,2
booze,1,0,0,1,2
boring,1,0,1,0,2
bostonian,2,0,0,0,2
boulangerie,0,0,2,0,2
boulevard,0,0,2,0,2
boundary,1,1,0,0,2
bowral,0,2,0,0,2
brass,0,0,1,1,2
breach,0,1,1,0,2
brewery,1,0,0,1,2
brief,0,2,0,0,2
brighton,2,0,0,0,2
brilliant,0,2,0,0,2
brings,0,1,1,0,2
bronson,0,0,0,2,2
brook,2,0,0,0,2
bros,2,0,0,0,2
brunch,0,1,1,0,2
btiment,0,0,2,0,2
btw,1,0,0,1,2
bu,2,0,0,0,2
bug,0,1,0,1,2
bulk,0,0,0,2,2
bullet,2,0,0,0,2
bullshit,1,1,0,0,2
burlington,2,0,0,0,2
burn,0,2,0,0,2
burnt,1,1,0,0,2
butcher,0,1,0,1,2
butt,1,0,1,0,2
butter,1,0,1,0,2
button,0,0,2,0,2
buvette,0,0,2,0,2
buzz,0,2,0,0,2
cabinet,1,0,1,0,2
calendar,1,0,0,1,2
calwell,0,2,0,0,2
candy,1,0,0,1,2
capable,0,0,0,2,2
capitalize,2,0,0,0,2
carrot,0,0,0,2,2
cart,0,1,0,1,2
carving,1,0,0,1,2
caution,0,0,1,1,2
cdl,0,0,2,0,2
century,2,0,0,0,2
ceux,0,0,2,0,2
chain,0,0,0,2,2
charlestown,2,0,0,0,2
charlie,1,0,1,0,2
charm,0,1,0,1,2
charnwood,0,2,0,0,2
chatty,0,2,0,0,2
cheaper,0,1,1,0,2
cherche,0,0,2,0,2
cherry,0,1,0,1,2
chicago,2,0,0,0,2
chronic,1,1,0,0,2
chuck,0,2,0,0,2
ciao,0,0,2,0,2
cinema,0,2,0,0,2
cinnamon,1,0,0,1,2
circuit,1,1,0,0,2
circulation,0,0,2,0,2
circumstance,0,0,2,0,2
claridge,0,0,0,2,2
claudel,0,0,0,2,2
clearance,0,1,0,1,2
cloudy,2,0,0,0,2
clover,0,2,0,0,2
clue,0,0,0,2,2
coastal,1,1,0,0,2
collector,1,1,0,0,2
collision,0,0,0,2,2
color,1,0,1,0,2
combined,1,1,0,0,2
combo,1,0,0,1,2
comedy,0,0,0,2,2
comfortably,0,0,2,0,2
commenter,1,0,0,1,2
communal,1,0,1,0,2
compel,1,1,0,0,2
compete,0,1,1,0,2
complicate,0,0,2,0,2
complique,0,0,2,0,2
component,2,0,0,0,2
concernent,0,0,2,0,2
conclusion,0,1,1,0,2
confused,1,0,0,1,2
conseil,0,0,2,0,2
consequence,1,0,0,1,2
conservative,1,0,1,0,2
consignment,0,0,1,1,2
consistent,0,0,1,1,2
consult,1,0,1,0,2
consumer,0,0,1,1,2
contribu,0,0,2,0,2
contribution,0,1,1,0,2
convenience,2,0,0,0,2
coop,0,0,2,0,2
coordination,1,0,0,1,2
copy,0,0,2,0,2
corridor,0,1,0,1,2
corrupt,1,0,1,0,2
cos,0,1,1,0,2
cot,0,0,2,0,2
cotton,0,0,0,2,2
cowboy,0,0,0,2,2
coz,0,2,0,0,2
crappy,1,0,0,1,2
crche,0,0,1,1,2
criticism,1,1,0,0,2
crochet,0,0,0,2,2
crowded,1,0,0,1,2
cucumber,0,0,0,2,2
cull,1,1,0,0,2
culturally,0,0,2,0,2
cumulative,0,1,1,0,2
cunt,2,0,0,0,2
cure,0,0,0,2,2
curiosity,0,0,1,1,2
cyclists,1,0,1,0,2
dam,0,2,0,0,2
darn,1,1,0,0,2
darwin,2,0,0,0,2
dc,1,0,1,0,2
dear,1,1,0,0,2
debit,0,0,1,1,2
decently,1,0,1,0,2
decides,1,0,1,0,2
declare,1,0,1,0,2
deductible,0,0,2,0,2
deem,1,0,1,0,2
defence,0,2,0,0,2
define,1,0,0,1,2
dei,1,0,0,1,2
demande,0,0,2,0,2
densely,1,0,1,0,2
dependent,1,0,1,0,2
deport,2,0,0,0,2
depreciation,0,2,0,0,2
depress,1,0,0,1,2
derniers,0,0,2,0,2
descend,1,0,1,0,2
descent,1,0,1,0,2
desert,0,1,0,1,2
desk,0,2,0,0,2
desperate,1,1,0,0,2
desperation,0,1,1,0,2
determine,0,1,1,0,2
detriment,0,0,1,1,2
devastating,0,0,0,2,2
developed,0,0,2,0,2
devil,1,1,0,0,2
dgrade,0,0,2,0,2
diagnose,0,1,0,1,2
dice,1,1,0,0,2
dictate,0,0,0,2,2
difficulty,0,1,0,1,2
diffrents,0,0,2,0,2
diligent,2,0,0,0,2
disability,0,1,0,1,2
disadvantage,0,1,1,0,2
disagree,1,0,1,0,2
disaster,0,0,0,2,2
discourage,0,0,0,2,2
discriminate,1,1,0,0,2
dismiss,0,2,0,0,2
disrespectful,1,0,0,1,2
dissident,2,0,0,0,2
distant,0,0,1,1,2
disturb,0,0,0,2,2
ditch,0,0,0,2,2
diver,1,0,1,0,2
diversity,2,0,0,0,2
diy,0,2,0,0,2
dominant,1,1,0,0,2
dominion,0,0,0,2,2
donn,0,0,2,0,2
donne,0,0,2,0,2
donnent,0,0,2,0,2
dorm,1,0,1,0,2
dough,0,0,2,0,2
downsize,0,0,1,1,2
downtime,0,0,0,2,2
downvoted,1,0,1,0,2
dramatically,0,2,0,0,2
drawback,0,1,0,1,2
dreadful,0,1,0,1,2
dtail,0,0,1,1,2
dull,0,0,1,1,2
dunkin,2,0,0,0,2
dunno,1,1,0,0,2
earth,1,0,0,1,2
eau,0,0,2,0,2
ecosystem,1,0,1,0,2
electricity,0,0,0,2,2
eligible,0,0,1,1,2
elitist,0,0,2,0,2
embrace,0,1,1,0,2
emotionally,0,0,1,1,2
emperor,0,1,0,1,2
emphasis,0,0,1,1,2
encompass,1,0,0,1,2
encounter,0,0,1,1,2
endorsement,2,0,0,0,2
enfant,0,0,1,1,2
engineer,0,0,2,0,2
engineering,1,1,0,0,2
ensuite,0,0,1,1,2
entity,2,0,0,0,2
equip,0,0,1,1,2
equity,2,0,0,0,2
er,0,0,0,2,2
erindale,0,2,0,0,2
escalator,0,2,0,0,2
escape,0,0,2,0,2
ev,0,0,0,2,2
evaporate,0,1,1,0,2
everyday,0,1,1,0,2
evil,2,0,0,0,2
excel,1,0,0,1,2
exceptional,0,1,0,1,2
excuse,1,0,1,0,2
existe,0,0,2,0,2
existence,0,1,0,1,2
exorbitant,0,1,0,1,2
exotic,2,0,0,0,2
exploitation,1,1,0,0,2
explosion,0,1,0,1,2
expose,1,0,1,0,2
exposure,1,0,0,1,2
exteme,0,0,2,0,2
extension,0,1,0,1,2
extent,1,0,0,1,2
extract,1,0,0,1,2
extremity,1,0,0,1,2
facial,2,0,0,0,2
facilitate,0,1,1,0,2
faire,0,0,2,0,2
favorite,0,0,2,0,2
favour,0,0,1,1,2
feral,1,0,1,0,2
fermes,0,0,2,0,2
fever,2,0,0,0,2
fibre,0,1,0,1,2
fierce,0,0,1,1,2
fifth,0,1,0,1,2
financially,1,0,1,0,2
financire,0,0,2,0,2
fitchburg,2,0,0,0,2
fitness,0,2,0,0,2
flatbread,2,0,0,0,2
flavor,2,0,0,0,2
flee,2,0,0,0,2
float,0,1,0,1,2
flock,1,1,0,0,2
flour,1,0,0,1,2
fluently,0,0,2,0,2
fluid,0,0,0,2,2
foggy,0,1,1,0,2
forbid,1,0,1,0,2
foreigner,1,1,0,0,2
forgets,0,1,0,1,2
formal,2,0,0,0,2
forth,0,2,0,0,2
fortnight,0,2,0,0,2
fortunately,0,0,2,0,2
fortune,0,1,0,1,2
foundation,0,0,1,1,2
fourth,1,1,0,0,2
foyer,0,1,1,0,2
fr,0,0,1,1,2
fracture,1,0,0,1,2
francophone,0,0,1,1,2
frank,1,1,0,0,2
freezing,0,1,0,1,2
freshly,2,0,0,0,2
fribourg,0,0,2,0,2
fridge,0,1,0,1,2
frog,1,0,0,1,2
frontage,0,2,0,0,2
frost,1,1,0,0,2
frustration,1,0,0,1,2
fucker,1,1,0,0,2
functional,0,1,0,1,2
fuss,0,1,0,1,2
gain,0,1,1,0,2
gamble,0,0,0,2,2
garantie,0,0,2,0,2
generic,0,1,0,1,2
generosity,1,0,0,1,2
generous,0,1,1,0,2
genius,1,1,0,0,2
gens,0,0,2,0,2
gently,1,0,0,1,2
gentrification,2,0,0,0,2
germany,1,0,1,0,2
girly,1,0,0,1,2
glassblower,2,0,0,0,2
gm,1,1,0,0,2
googong,0,2,0,0,2
gotcha,1,1,0,0,2
gotten,1,0,0,1,2
goulburn,0,2,0,0,2
gov,1,1,0,0,2
govern,0,2,0,0,2
govt,0,2,0,0,2
graphic,0,2,0,0,2
gravity,0,1,0,1,2
graze,0,1,0,1,2
greasy,0,1,1,0,2
greatly,0,0,1,1,2
grocer,0,2,0,0,2
gross,0,1,1,0,2
grottes,0,0,2,0,2
grouse,0,2,0,0,2
gta,0,0,0,2,2
guidance,0,2,0,0,2
guitar,0,0,0,2,2
gun,2,0,0,0,2
hack,0,0,0,2,2
haircut,0,1,0,1,2
halfway,0,0,1,1,2
halloween,0,1,1,0,2
hamlet,0,2,0,0,2
hampshire,2,0,0,0,2
handmade,0,1,0,1,2
happens,0,1,0,1,2
hardcore,0,1,0,1,2
harder,2,0,0,0,2
harris,1,0,0,1,2
harvest,0,0,0,2,2
hay,1,1,0,0,2
hazard,0,1,0,1,2
headphone,0,0,1,1,2
healey,2,0,0,0,2
hearing,2,0,0,0,2
heater,0,1,1,0,2
heating,2,0,0,0,2
heavily,0,1,1,0,2
hen,1,1,0,0,2
hesitate,1,0,1,0,2
heyday,1,0,0,1,2
hhs,2,0,0,0,2
highlight,1,0,0,1,2
hiking,0,0,2,0,2
hinder,1,0,1,0,2
historical,0,1,1,0,2
historically,1,0,0,1,2
holy,0,1,0,1,2
honk,0,1,1,0,2
honking,1,0,1,0,2
hoodie,1,0,1,0,2
humour,0,0,0,2,2
hunter,1,0,0,1,2
hygienist,1,0,1,0,2
hyundai,0,0,0,2,2
ib,0,0,1,1,2
identification,0,0,1,1,2
ignorance,2,0,0,0,2
ill,1,0,1,0,2
illegally,2,0,0,0,2
ils,0,0,2,0,2
imho,1,0,1,0,2
immersive,0,2,0,0,2
impots,0,0,2,0,2
impressed,1,0,1,0,2
impressive,0,1,0,1,2
impts,0,0,2,0,2
inaccessible,1,0,1,0,2
incestuous,0,1,1,0,2
inconsistent,1,1,0,0,2
inconvenience,2,0,0,0,2
inconvenient,0,0,1,1,2
increased,0,2,0,0,2
incredible,2,0,0,0,2
incumbent,2,0,0,0,2
indian,0,1,1,0,2
indicate,0,1,1,0,2
indoors,1,1,0,0,2
inexpensive,1,0,0,1,2
infection,2,0,0,0,2
inflation,1,0,0,1,2
informed,0,2,0,0,2
innovation,0,1,1,0,2
insensible,0,0,2,0,2
insert,0,1,0,1,2
insignificant,0,0,1,1,2
insist,0,0,0,2,2
inspiration,0,1,1,0,2
insta,0,0,2,0,2
instigate,1,0,1,0,2
institute,1,0,1,0,2
instrument,0,1,1,0,2
int,0,0,1,1,2
integration,0,1,1,0,2
intense,1,0,0,1,2
interactive,1,0,1,0,2
interchange,0,2,0,0,2
intercontinental,0,0,2,0,2
internal,0,0,1,1,2
interrupt,0,0,2,0,2
interstate,1,1,0,0,2
intl,0,1,1,0,2
intrinsically,0,0,1,1,2
invariably,1,1,0,0,2
inventory,2,0,0,0,2
ipad,1,0,1,0,2
ipub,0,0,2,0,2
ireland,2,0,0,0,2
irrelevant,1,1,0,0,2
isolated,0,2,0,0,2
isolation,0,1,1,0,2
ive,0,0,0,2,2
jack,1,0,0,1,2
jamaica,2,0,0,0,2
jamais,0,0,2,0,2
japan,0,1,1,0,2
jerrabomberra,0,2,0,0,2
joel,0,1,0,1,2
joint,1,1,0,0,2
journalist,1,1,0,0,2
joy,1,0,0,1,2
jp,2,0,0,0,2
junior,0,1,1,0,2
jura,0,0,2,0,2
jusqu,0,0,2,0,2
karaoke,0,0,0,2,2
kept,0,0,0,2,2
kilometre,0,1,1,0,2
kit,1,0,0,1,2
kmart,0,2,0,0,2
knew,0,1,1,0,2
knowingly,2,0,0,0,2
known,0,0,1,1,2
korean,0,2,0,0,2
labour,0,0,1,1,2
latte,1,0,1,0,2
laugh,1,1,0,0,2
launch,0,2,0,0,2
lavaux,0,0,2,0,2
layout,1,1,0,0,2
lea,0,0,2,0,2
learning,0,0,1,1,2
ledger,1,0,0,1,2
legion,1,0,0,1,2
legislature,2,0,0,0,2
legitimate,1,0,1,0,2
legitimately,1,0,0,1,2
lengthy,1,0,0,1,2
lettuce,0,0,0,2,2
leur,0,0,2,0,2
lev,0,0,2,0,2
lgal,0,0,2,0,2
li,0,0,2,0,2
lien,0,0,2,0,2
lieu,0,0,2,0,2
lightly,0,0,0,2,2
lil,0,2,0,0,2
lime,1,0,0,1,2
lincoln,1,0,0,1,2
linkedin,0,0,0,2,2
liquor,1,0,0,1,2
listing,0,1,1,0,2
litter,0,0,1,1,2
llm,0,0,2,0,2
lmao,1,0,0,1,2
lments,0,0,2,0,2
logical,0,1,0,1,2
longtemps,0,0,2,0,2
loose,0,2,0,0,2
luggage,0,0,2,0,2
lui,0,0,2,0,2
lunetta,0,2,0,0,2
lutry,0,0,2,0,2
mad,2,0,0,0,2
magic,0,1,0,1,2
magically,0,0,2,0,2
magpie,0,2,0,0,2
mainstream,1,0,0,1,2
maison,0,0,2,0,2
mandate,0,1,0,1,2
manufacture,1,0,1,0,2
manuka,0,2,0,0,2
maple,0,0,0,2,2
massage,0,1,0,1,2
masshealth,2,0,0,0,2
maturity,0,0,1,1,2
maximum,1,1,0,0,2
meaningful,2,0,0,0,2
meantime,1,0,0,1,2
mecca,0,2,0,0,2
med,1,0,0,1,2
medford,2,0,0,0,2
medicine,1,0,0,1,2
meilleur,0,0,2,0,2
melting,0,1,1,0,2
memorial,0,1,0,1,2
mercedes,0,0,0,2,2
merci,0,0,1,1,2
merry,0,1,1,0,2
mi,1,0,1,0,2
miami,1,1,0,0,2
michael,1,0,0,1,2
micro,1,0,1,0,2
microwave,0,1,0,1,2
midday,0,1,0,1,2
mieux,0,0,2,0,2
mike,2,0,0,0,2
milk,0,2,0,0,2
milkshake,1,1,0,0,2
mindset,0,0,1,1,2
minister,0,2,0,0,2
minto,0,0,0,2,2
minus,1,0,0,1,2
miracle,0,0,1,1,2
mitchell,0,2,0,0,2
mock,1,0,0,1,2
mom,2,0,0,0,2
moral,2,0,0,0,2
moron,0,1,1,0,2
mortgage,1,0,1,0,2
mot,0,1,0,1,2
motel,0,1,1,0,2
motion,0,0,0,2,2
motorbike,0,0,2,0,2
mount,0,2,0,0,2
mower,0,2,0,0,2
mowing,0,2,0,0,2
mp,0,0,0,2,2
mr,0,2,0,0,2
msc,0,0,1,1,2
muscle,1,0,1,0,2
muslim,1,1,0,0,2
nail,0,2,0,0,2
narrative,2,0,0,0,2
naturally,0,0,2,0,2
navigator,1,0,0,1,2
nb,0,0,1,1,2
ncc,0,0,0,2,2
needle,0,1,0,1,2
negligence,0,0,0,2,2
neighbouring,0,0,1,1,2
neighbourly,0,0,0,2,2
neon,0,0,2,0,2
nervous,0,0,0,2,2
neurodivergent,0,2,0,0,2
newly,0,0,2,0,2
nih,2,0,0,0,2
niveau,0,0,2,0,2
nonetheless,0,0,1,1,2
nonprofit,2,0,0,0,2
nonsense,0,1,0,1,2
notification,1,0,0,1,2
nouvelle,0,0,2,0,2
numerous,1,0,0,1,2
nurse,0,1,0,1,2
nw,0,2,0,0,2
ny,1,0,1,0,2
nyquil,0,0,0,2,2
oak,1,1,0,0,2
obama,2,0,0,0,2
obey,1,0,1,0,2
objection,0,1,1,0,2
obscure,0,0,1,1,2
observe,1,0,1,0,2
obstruction,1,0,0,1,2
obv,0,0,1,1,2
occasion,0,1,1,0,2
occupy,1,0,0,1,2
occur,0,1,0,1,2
october,0,0,1,1,2
offset,1,1,0,0,2
oil,0,1,1,0,2
onward,2,0,0,0,2
opening,0,2,0,0,2
optional,0,0,0,2,2
oseg,0,0,0,2,2
outcome,0,1,1,0,2
outing,1,0,1,0,2
outlet,2,0,0,0,2
outstanding,0,1,0,1,2
oval,0,2,0,0,2
overlap,0,1,0,1,2
overseas,0,1,1,0,2
oversight,0,1,0,1,2
overstock,0,0,1,1,2
overwhelming,0,1,0,1,2
ownership,0,1,0,1,2
oyster,2,0,0,0,2
painful,0,0,2,0,2
palace,0,0,1,1,2
palladium,0,0,1,1,2
palm,0,0,0,2,2
pancake,0,1,0,1,2
pant,2,0,0,0,2
papa,0,1,0,1,2
parade,1,0,0,1,2
paradise,1,1,0,0,2
paragraph,0,1,0,1,2
parallel,0,1,1,0,2
pareil,0,0,2,0,2
parkdale,0,0,0,2,2
parkour,0,2,0,0,2
partial,0,1,1,0,2
partly,0,0,1,1,2
patio,0,0,0,2,2
patrick,0,0,0,2,2
patron,1,0,1,0,2
pdf,0,1,1,0,2
peel,0,1,1,0,2
peep,0,0,0,2,2
peer,0,0,1,1,2
percentage,0,0,0,2,2
permanent,1,0,1,0,2
permanently,1,0,1,0,2
permission,0,1,1,0,2
perpetuate,1,0,0,1,2
personnes,0,0,2,0,2
perth,0,1,0,1,2
pest,0,1,0,1,2
pester,0,0,1,1,2
petits,0,0,2,0,2
petrol,0,1,1,0,2
pharma,1,0,1,0,2
philip,0,2,0,0,2
phnomne,0,0,2,0,2
pickle,0,0,1,1,2
pierre,0,0,2,0,2
pink,1,0,0,1,2
pioneer,2,0,0,0,2
pire,0,0,2,0,2
pizzeria,0,1,1,0,2
pl,0,1,1,0,2
plaine,0,0,2,0,2
planet,2,0,0,0,2
plastic,0,1,1,0,2
pleasantly,0,0,1,1,2
plentiful,0,2,0,0,2
plutt,0,0,2,0,2
pm,0,1,1,0,2
po,0,0,2,0,2
poke,2,0,0,0,2
polite,0,0,2,0,2
politeness,1,0,1,0,2
politician,1,0,1,0,2
pont,0,0,2,0,2
populate,1,0,0,1,2
portfolio,1,0,1,0,2
pose,1,0,1,0,2
postcard,1,0,1,0,2
posting,0,0,0,2,2
posturing,0,1,1,0,2
potato,1,0,0,1,2
poultry,1,0,0,1,2
pound,0,0,0,2,2
poverty,2,0,0,0,2
powell,0,2,0,0,2
precedent,1,0,0,1,2
preference,0,2,0,0,2
premise,1,0,1,0,2
prescription,1,0,1,0,2
preservation,0,2,0,0,2
presidential,2,0,0,0,2
pretentious,0,1,1,0,2
preuves,0,0,2,0,2
prime,1,1,0,0,2
principle,0,1,1,0,2
prioritize,1,0,0,1,2
prise,0,0,2,0,2
prison,1,0,1,0,2
proceed,1,0,0,1,2
producer,0,0,0,2,2
productivity,0,1,1,0,2
profession,0,0,1,1,2
profile,0,0,2,0,2
progressive,1,0,0,1,2
prohibit,0,0,2,0,2
proof,1,0,0,1,2
proportionally,0,1,1,0,2
propritaire,0,0,2,0,2
prospect,1,1,0,0,2
protected,2,0,0,0,2
provision,2,0,0,0,2
psych,0,1,0,1,2
puddle,1,1,0,0,2
puis,0,0,2,0,2
punish,1,0,1,0,2
puplinge,0,0,2,0,2
purely,0,1,1,0,2
qld,0,2,0,0,2
qualification,0,1,1,0,2
quasi,1,0,1,0,2
qubec,0,0,0,2,2
quelque,0,0,2,0,2
quelques,0,0,2,0,2
quoi,0,0,2,0,2
racial,2,0,0,0,2
racing,2,0,0,0,2
racism,1,1,0,0,2
raid,1,0,0,1,2
rant,0,1,1,0,2
rap,1,0,0,1,2
rapidly,0,0,2,0,2
ratio,1,0,1,0,2
rcemment,0,0,2,0,2
recall,1,0,0,1,2
recommand,0,0,2,0,2
recovery,1,0,0,1,2
rectangular,0,2,0,0,2
redesign,1,0,0,1,2
redevelopment,1,1,0,0,2
redline,2,0,0,0,2
redundant,1,0,0,1,2
reflection,0,0,1,1,2
reintroduce,0,0,2,0,2
reject,0,0,2,0,2
reliability,1,0,0,1,2
remarqu,0,0,2,0,2
reminder,0,0,2,0,2
reminds,1,1,0,0,2
remote,1,1,0,0,2
remotely,1,0,0,1,2
rename,0,0,0,2,2
rendre,0,0,2,0,2
renew,0,1,1,0,2
rentrer,0,0,2,0,2
reoit,0,0,2,0,2
reopen,0,1,1,0,2
reputable,0,2,0,0,2
reschedule,2,0,0,0,2
resistance,1,1,0,0,2
restore,1,1,0,0,2
retour,0,0,2,0,2
reuse,1,0,0,1,2
revolution,2,0,0,0,2
rhne,0,0,2,0,2
rhone,0,0,2,0,2
richmond,1,0,0,1,2
rigor,0,0,2,0,2
ring,0,1,0,1,2
riotact,0,2,0,0,2
riverside,0,1,0,1,2
roadway,2,0,0,0,2
roast,0,1,1,0,2
rodent,0,1,0,1,2
rope,1,1,0,0,2
routine,1,1,0,0,2
rowdy,1,0,1,0,2
roxbury,2,0,0,0,2
royalty,0,1,1,0,2
rsv,1,0,0,1,2
runner,0,1,1,0,2
rusty,2,0,0,0,2
salaires,0,0,2,0,2
salem,2,0,0,0,2
salve,0,0,2,0,2
sandy,0,1,0,1,2
sanitation,2,0,0,0,2
sanity,0,1,0,1,2
sat,2,0,0,0,2
satisfy,0,1,0,1,2
savvy,1,0,0,1,2
scali,0,2,0,0,2
scare,0,1,0,1,2
scooter,0,0,2,0,2
scullin,0,2,0,0,2
sculpture,1,0,0,1,2
scum,2,0,0,0,2
seal,0,2,0,0,2
seaport,2,0,0,0,2
seattle,1,1,0,0,2
secular,1,0,0,1,2
secure,0,0,2,0,2
seed,0,0,0,2,2
selfish,0,0,2,0,2
sensible,0,0,2,0,2
september,0,0,1,1,2
serum,0,0,2,0,2
servicing,0,1,0,1,2
sew,0,0,0,2,2
sewage,0,2,0,0,2
sewer,0,0,1,1,2
sexual,0,1,0,1,2
shadow,1,1,0,0,2
shallow,1,1,0,0,2
sham,0,1,1,0,2
shine,1,0,1,0,2
shiver,1,0,0,1,2
shocked,0,1,1,0,2
shortage,1,0,0,1,2
shortly,0,1,1,0,2
shoulder,1,1,0,0,2
shove,1,0,1,0,2
shovel,2,0,0,0,2
shower,1,0,0,1,2
shred,1,1,0,0,2
shy,0,1,0,1,2
signal,1,0,1,0,2
silent,0,0,1,1,2
silly,1,1,0,0,2
silver,0,2,0,0,2
similarly,0,1,0,1,2
simplement,0,0,2,0,2
simplify,2,0,0,0,2
sing,1,0,0,1,2
sinon,0,0,2,0,2
situs,0,0,2,0,2
slack,0,1,0,1,2
slam,0,0,0,2,2
slogan,0,0,0,2,2
slowly,0,0,1,1,2
smoking,1,0,1,0,2
snake,1,1,0,0,2
soak,0,1,0,1,2
soccer,1,0,0,1,2
sociale,0,0,2,0,2
socialise,0,1,1,0,2
software,0,0,2,0,2
soggy,0,0,1,1,2
soir,0,0,2,0,2
solo,1,0,1,0,2
someplace,0,0,1,1,2
sooner,1,0,1,0,2
sooo,0,0,1,1,2
soooo,0,2,0,0,2
sous,0,0,1,1,2
souvenir,0,1,1,0,2
spain,0,0,2,0,2
spanish,1,0,1,0,2
spare,1,0,1,0,2
spec,0,1,0,1,2
specialise,0,1,1,0,2
spectrum,0,1,0,1,2
speech,1,0,1,0,2
spell,0,1,0,1,2
spence,0,2,0,0,2
spent,0,1,0,1,2
spin,0,1,0,1,2
spite,0,1,0,1,2
sponsor,1,0,1,0,2
spouse,0,0,2,0,2
sprawl,0,0,0,2,2
sprinkle,2,0,0,0,2
spy,2,0,0,0,2
squirrel,1,0,0,1,2
sr,0,0,2,0,2
stale,0,2,0,0,2
starbucks,2,0,0,0,2
steam,0,1,1,0,2
steer,0,1,0,1,2
sth,0,2,0,0,2
sticker,2,0,0,0,2
stoneham,2,0,0,0,2
straightforward,0,0,1,1,2
strand,1,0,0,1,2
strange,0,0,2,0,2
strategic,0,1,1,0,2
stratum,0,2,0,0,2
stream,0,1,1,0,2
streetview,1,0,1,0,2
stubhub,0,0,0,2,2
stupidly,0,1,1,0,2
subsidise,0,2,0,0,2
suburbs,0,1,1,0,2
successive,0,2,0,0,2
suffer,2,0,0,0,2
suffit,0,0,2,0,2
suitable,0,1,0,1,2
sum,0,0,0,2,2
supporter,1,1,0,0,2
surgical,0,2,0,0,2
surpass,1,0,1,0,2
surplus,0,1,0,1,2
surprisingly,0,1,0,1,2
surrounding,1,0,1,0,2
surveillance,2,0,0,0,2
swimming,0,1,0,1,2
sympa,0,0,2,0,2
sympathize,1,0,0,1,2
sync,0,1,1,0,2
tablespoon,1,0,0,1,2
tactic,0,0,0,2,2
tag,0,0,1,1,2
taille,0,0,2,0,2
targ,0,0,0,2,2
tatte,2,0,0,0,2
taught,2,0,0,0,2
tavern,1,0,0,1,2
tear,0,2,0,0,2
teeth,0,2,0,0,2
telephoto,0,0,0,2,2
temporarily,0,0,0,2,2
tennis,0,0,2,0,2
tent,0,1,0,1,2
terme,0,0,1,1,2
terrify,1,0,0,1,2
territoire,0,0,2,0,2
thankfully,0,1,1,0,2
theater,1,0,1,0,2
theory,0,0,1,1,2
theres,0,0,1,1,2
thief,0,0,1,1,2
tho,0,1,1,0,2
thoroughly,0,0,1,1,2
thrive,0,1,0,1,2
thunder,0,2,0,0,2
timeline,1,1,0,0,2
tinder,0,0,0,2,2
tired,0,0,2,0,2
title,1,0,0,1,2
tl,0,1,1,0,2
told,0,1,0,1,2
tolerance,1,1,0,0,2
tonight,1,0,1,0,2
tooth,0,1,0,1,2
toujours,0,0,2,0,2
tow,1,0,0,1,2
toy,1,0,1,0,2
trace,0,1,1,0,2
tradition,0,0,2,0,2
trailer,0,1,0,1,2
transaction,0,1,1,0,2
trap,0,0,1,1,2
trauma,1,0,1,0,2
travail,0,0,2,0,2
travaille,0,0,2,0,2
treadmill,0,0,1,1,2
trembley,0,0,2,0,2
tremendously,2,0,0,0,2
tremont,2,0,0,0,2
trespass,0,0,1,1,2
trial,1,1,0,0,2
tribunal,0,0,2,0,2
trident,2,0,0,0,2
trigger,0,1,0,1,2
triple,1,0,0,1,2
tsa,2,0,0,0,2
tube,0,1,0,1,2
tuck,1,0,0,1,2
tuggeranong,0,2,0,0,2
turkey,1,0,1,0,2
twint,0,0,2,0,2
ugh,0,1,0,1,2
ugly,0,0,0,2,2
unable,0,0,2,0,2
unacceptable,2,0,0,0,2
unanimous,1,1,0,0,2
unclear,0,0,0,2,2
underlying,0,2,0,0,2
underneath,0,0,1,1,2
undocumented,2,0,0,0,2
unhinged,0,2,0,0,2
unicorn,0,1,0,1,2
uniquement,0,0,2,0,2
united,1,0,1,0,2
universities,1,0,1,0,2
unlikely,0,1,1,0,2
unlucky,0,1,0,1,2
unpaid,0,1,1,0,2
unpleasant,0,1,0,1,2
unplug,1,0,0,1,2
unqualified,0,0,1,1,2
unreasonable,1,1,0,0,2
unrelated,0,0,1,1,2
unseasonably,0,1,0,1,2
upgrade,0,1,0,1,2
ups,0,0,0,2,2
upset,1,1,0,0,2
upwards,1,1,0,0,2
urgent,1,1,0,0,2
ute,0,2,0,0,2
utilis,0,0,1,1,2
utterly,0,1,1,0,2
vacant,0,1,0,1,2
valable,0,0,2,0,2
vancouver,0,0,0,2,2
variable,0,0,0,2,2
vasted,0,0,2,0,2
vc,0,2,0,0,2
veg,1,1,0,0,2
venant,0,0,2,0,2
venture,0,2,0,0,2
verge,0,2,0,0,2
veut,0,0,2,0,2
viable,0,0,2,0,2
vineyard,0,0,2,0,2
violence,1,0,1,0,2
virgin,0,2,0,0,2
visa,0,0,2,0,2
vital,2,0,0,0,2
viter,0,0,2,0,2
vois,0,0,2,0,2
voiture,0,0,2,0,2
voucher,0,0,2,0,2
voyage,0,0,2,0,2
vu,0,0,2,0,2
vue,0,0,2,0,2
vulnerable,1,1,0,0,2
wa,0,2,0,0,2
wade,1,0,0,1,2
waitlisted,1,0,0,1,2
wallet,0,0,1,1,2
waltham,2,0,0,0,2
wanniassa,0,2,0,0,2
ward,0,0,0,2,2
warehouse,0,1,0,1,2
warranty,0,0,0,2,2
wealth,1,1,0,0,2
wellington,1,0,0,1,2
westboro,0,0,0,2,2
weston,0,2,0,0,2
wetland,0,2,0,0,2
wheel,0,1,0,1,2
whilst,1,0,1,0,2
whiskey,1,1,0,0,2
wholesale,1,0,0,1,2
wicket,1,1,0,0,2
wide,0,2,0,0,2
wilson,0,0,1,1,2
winchester,1,1,0,0,2
winery,0,2,0,0,2
wont,0,1,0,1,2
workout,1,1,0,0,2
workplace,0,2,0,0,2
worthy,1,1,0,0,2
woth,0,1,0,1,2
yankee,2,0,0,0,2
yarralumla,0,2,0,0,2
yep,1,1,0,0,2
yield,1,0,1,0,2
yr,0,1,0,1,2
yuk,0,0,0,2,2
yuks,0,0,0,2,2
zoom,1,1,0,0,2
zucchini,0,0,0,2,2
